TransactionDate,Location,ItemName,Cost,SaleQty,SaleBonusQty,SaleTotalQty,MRP,SaleAmount,PerInvoiceAverageAmount
25-Oct-23,Brahmaputra,Clean 100ml,250,50,4,54,940,47000,44439.81
25-Oct-23,Brahmaputra,Clean 100ml,250,10,0,10,940,9400,12013.21
22-Oct-23,Brahmaputra,Clean 100ml,250,20,1,21,940,18800,92327.94
21-Oct-23,Brahmaputra,Clean 100ml,250,6,0,6,940,5640,16732.52
19-Oct-23,Brahmaputra,Clean 100ml,250,20,1,21,940,18800,11170.89
16-Oct-23,Brahmaputra,Clean 100ml,250,100,10,110,940,94000,136129.58
16-Oct-23,Brahmaputra,Clean 100ml,250,20,1,21,940,18800,27274.83
15-Oct-23,Brahmaputra,Clean 100ml,250,20,1,21,940,18800,31217.98
8-Oct-23,Brahmaputra,Clean 100ml,250,20,1,21,940,18800,16708.05
4-Oct-23,Brahmaputra,Clean 100ml,250,20,1,21,940,18800,60293.05
1-Oct-23,Brahmaputra,Clean 100ml,250,2,0,2,940,1880,19977.16
27-Sep-23,Brahmaputra,Clean 100ml,250,16,0,16,940,15040,35418.62
27-Sep-23,Brahmaputra,Clean 100ml,250,24,3,27,940,22560,35418.62
27-Sep-23,Brahmaputra,Clean 100ml,250,20,1,21,940,18800,26931.35
10-Sep-23,Brahmaputra,Clean 100ml,250,2,0,2,940,1880,5558.05
4-Sep-23,Brahmaputra,Clean 100ml,250,20,1,21,940,18800,35111.33
30-Aug-23,Brahmaputra,Clean 100ml,250,10,0,10,940,9400,20700.96
24-Aug-23,Brahmaputra,Clean 100ml,250,40,3,43,940,37600,35590.73
24-Aug-23,Brahmaputra,Clean 100ml,250,2,0,2,940,1880,31217.98
24-Aug-23,Brahmaputra,Clean 100ml,250,8,0,8,940,7520,31217.98
24-Aug-23,Brahmaputra,Clean 100ml,250,5,0,5,940,4700,31747.84
22-Aug-23,Brahmaputra,Clean 100ml,250,14,0,14,940,13160,35669.3
22-Aug-23,Brahmaputra,Clean 100ml,250,6,1,7,940,5640,35669.3
21-Aug-23,Brahmaputra,Clean 100ml,250,20,1,21,940,18800,69012.92
21-Aug-23,Brahmaputra,Clean 100ml,250,60,5,65,940,56400,44439.81
20-Aug-23,Brahmaputra,Clean 100ml,250,20,1,21,940,18800,28520.47
16-Aug-23,Brahmaputra,Clean 100ml,250,1,0,1,940,940,31217.98
16-Aug-23,Brahmaputra,Clean 100ml,250,4,0,4,940,3760,31217.98
3-Aug-23,Brahmaputra,Clean 100ml,250,20,1,21,940,18800,58340.12
1-Aug-23,Brahmaputra,Clean 100ml,250,40,3,43,940,37600,16732.52
30-Jul-23,Brahmaputra,Clean 100ml,250,40,3,43,940,37600,28027.58
25-Jul-23,Brahmaputra,Clean 100ml,250,40,3,43,940,37600,56329.79
16-Jul-23,Brahmaputra,Clean 100ml,250,20,1,21,940,18800,32294.06
13-Jul-23,Brahmaputra,Clean 100ml,250,20,1,21,940,18800,28520.47
11-Jul-23,Brahmaputra,Clean 100ml,250,20,1,21,940,18800,19977.16
10-Jul-23,Brahmaputra,Clean 100ml,250,100,11,111,940,94000,223788.7
10-Jul-23,Brahmaputra,Clean 100ml,250,20,1,21,940,18800,92980.71
10-Jul-23,Brahmaputra,Clean 100ml,250,60,5,65,940,56400,27538.23
15-Jun-23,Brahmaputra,Clean 100ml,250,20,1,21,940,18800,56329.79
14-Jun-23,Brahmaputra,Clean 100ml,250,30,1,31,940,28200,35418.62
10-Jun-23,Brahmaputra,Clean 100ml,250,5,0,5,940,4700,46238.53
7-Jun-23,Brahmaputra,Clean 100ml,250,10,0,10,940,9400,8920.83
28-May-23,Brahmaputra,Clean 100ml,250,10,0,10,940,9400,31217.98
21-May-23,Brahmaputra,Clean 100ml,250,40,3,43,940,37600,35590.73
21-May-23,Brahmaputra,Clean 100ml,250,5,0,5,940,4700,12013.21
18-May-23,Brahmaputra,Clean 100ml,250,10,0,10,940,9400,13322.33
16-May-23,Brahmaputra,Clean 100ml,250,20,1,21,940,18800,14631.6
14-May-23,Brahmaputra,Clean 100ml,250,50,3,53,940,47000,92327.94
11-May-23,Brahmaputra,Clean 100ml,250,5,0,5,940,4700,22387.66
11-May-23,Brahmaputra,Clean 100ml,250,20,1,21,940,18800,27274.83
10-May-23,Brahmaputra,Clean 100ml,250,6,0,6,940,5640,35669.3
10-May-23,Brahmaputra,Clean 100ml,250,14,1,15,940,13160,35669.3
8-May-23,Brahmaputra,Clean 100ml,250,20,1,21,940,18800,56329.79
8-May-23,Brahmaputra,Clean 100ml,250,20,1,21,940,18800,11170.89
7-May-23,Brahmaputra,Clean 100ml,250,20,1,21,940,18800,16708.05
2-May-23,Brahmaputra,Clean 100ml,250,200,0,200,940,188000,186021.36
2-May-23,Brahmaputra,Clean 100ml,250,0,25,25,940,0,186021.36
27-Apr-23,Brahmaputra,Clean 100ml,250,5,0,5,940,4700,58340.12
13-Apr-23,Brahmaputra,Clean 100ml,250,6,0,6,940,5640,21250.97
6-Apr-23,Brahmaputra,Clean 100ml,250,60,5,65,940,56400,44658.13
6-Apr-23,Brahmaputra,Clean 100ml,250,20,1,21,940,18800,35111.33
4-Apr-23,Brahmaputra,Clean 100ml,250,40,3,43,940,37600,125931.38
4-Apr-23,Brahmaputra,Clean 100ml,250,20,1,21,940,18800,26130.21
30-Mar-23,Brahmaputra,Clean 100ml,250,20,1,21,940,18800,56329.79
25-Mar-23,Brahmaputra,Clean 100ml,250,14,0,14,940,13160,136129.58
25-Mar-23,Brahmaputra,Clean 100ml,250,48,5,53,940,45120,136129.58
23-Mar-23,Brahmaputra,Clean 100ml,250,20,1,21,940,18800,28027.58
22-Mar-23,Brahmaputra,Clean 100ml,250,1,0,1,940,940,16537.87
21-Mar-23,Brahmaputra,Clean 100ml,250,3,0,3,940,2820,8920.83
16-Mar-23,Brahmaputra,Clean 100ml,250,20,1,21,940,18800,67309.74
7-Mar-23,Brahmaputra,Clean 100ml,250,40,3,43,940,37600,35590.73
7-Mar-23,Brahmaputra,Clean 100ml,250,42,0,42,940,39480,32294.06
7-Mar-23,Brahmaputra,Clean 100ml,250,3,3,6,940,2820,32294.06
7-Mar-23,Brahmaputra,Clean 100ml,250,20,1,21,940,18800,31217.98
7-Mar-23,Brahmaputra,Clean 100ml,250,20,1,21,940,18800,56329.79
2-Mar-23,Brahmaputra,Clean 100ml,250,20,1,21,940,18800,11170.89
2-Mar-23,Brahmaputra,Clean 100ml,250,20,1,21,940,18800,19134.96
26-Feb-23,Brahmaputra,Clean 100ml,250,25,1,26,940,23500,47356.9
23-Feb-23,Brahmaputra,Clean 100ml,250,5,0,5,940,4700,22387.66
20-Feb-23,Brahmaputra,Clean 100ml,250,3,0,3,940,2820,16537.87
19-Feb-23,Brahmaputra,Clean 100ml,250,50,3,53,940,47000,44439.81
8-Feb-23,Brahmaputra,Clean 100ml,250,20,1,21,940,18800,35418.62
2-Feb-23,Brahmaputra,Clean 100ml,250,20,1,21,940,18800,69012.92
31-Jan-23,Brahmaputra,Clean 100ml,250,3,0,3,940,2820,95654.72
31-Jan-23,Brahmaputra,Clean 100ml,250,10,0,10,940,9400,19977.16
29-Jan-23,Brahmaputra,Clean 100ml,250,3,0,3,940,2820,95654.72
25-Jan-23,Brahmaputra,Clean 100ml,250,6,0,6,940,5640,35418.62
25-Jan-23,Brahmaputra,Clean 100ml,250,5,0,5,940,4700,11170.89
25-Jan-23,Brahmaputra,Clean 100ml,250,1,0,1,940,940,83786.67
25-Jan-23,Brahmaputra,Clean 100ml,250,59,5,64,940,55460,83786.67
23-Jan-23,Brahmaputra,Clean 100ml,250,20,1,21,940,18800,13124.32
21-Jan-23,Brahmaputra,Clean 100ml,250,3,0,3,940,2820,16537.87
19-Jan-23,Brahmaputra,Clean 100ml,250,6,0,6,940,5640,22027.5
11-Jan-23,Brahmaputra,Clean 100ml,250,20,1,21,940,18800,27274.83
10-Jan-23,Brahmaputra,Clean 100ml,250,10,0,10,940,9400,31217.98
8-Jan-23,Brahmaputra,Clean 100ml,250,60,5,65,940,56400,83786.67
2-Jan-23,Brahmaputra,Clean 100ml,250,2,0,2,940,1880,46238.53
2-Jan-23,Brahmaputra,Clean 100ml,250,3,0,3,940,2820,46238.53
27-Dec-22,Brahmaputra,Clean 100ml,250,10,0,10,940,9400,10861.18
27-Dec-22,Brahmaputra,Clean 100ml,250,3,0,3,940,2820,16708.05
25-Dec-22,Brahmaputra,Clean 100ml,250,60,5,65,940,56400,86662.15
24-Dec-22,Brahmaputra,Clean 100ml,250,20,1,21,940,18800,26130.21
24-Dec-22,Brahmaputra,Clean 100ml,250,20,1,21,940,18800,35590.73
21-Dec-22,Brahmaputra,Clean 100ml,250,20,1,21,940,18800,123151.84
21-Dec-22,Brahmaputra,Clean 100ml,250,100,11,111,940,94000,51556.19
20-Dec-22,Brahmaputra,Clean 100ml,250,20,1,21,940,18800,28520.47
18-Dec-22,Brahmaputra,Clean 100ml,250,100,0,100,940,94000,223788.7
18-Dec-22,Brahmaputra,Clean 100ml,250,0,10,10,940,0,223788.7
13-Dec-22,Brahmaputra,Clean 100ml,250,5,0,5,940,4700,35590.73
12-Dec-22,Brahmaputra,Clean 100ml,250,20,1,21,940,18800,47356.9
12-Dec-22,Brahmaputra,Clean 100ml,250,10,0,10,940,9400,8920.83
12-Dec-22,Brahmaputra,Clean 100ml,250,42,3,45,940,39480,56329.79
12-Dec-22,Brahmaputra,Clean 100ml,250,60,4,64,940,56400,44439.81
12-Dec-22,Brahmaputra,Clean 100ml,250,20,1,21,940,18800,8290.65
12-Dec-22,Brahmaputra,Clean 100ml,250,5,0,5,940,4700,31217.98
12-Dec-22,Brahmaputra,Clean 100ml,250,20,1,21,940,18800,17190.43
12-Dec-22,Brahmaputra,Clean 100ml,250,60,3,63,940,56400,37490.7
12-Dec-22,Brahmaputra,Clean 100ml,250,6,0,6,940,5640,31747.84
12-Dec-22,Brahmaputra,Clean 100ml,250,20,1,21,940,18800,19134.96
12-Dec-22,Brahmaputra,Clean 100ml,250,42,3,45,940,39480,44658.13
12-Dec-22,Brahmaputra,Clean 100ml,250,20,1,21,940,18800,26401.93
12-Dec-22,Brahmaputra,Clean 100ml,250,20,1,21,940,18800,20700.96
12-Dec-22,Brahmaputra,Clean 100ml,250,20,1,21,940,18800,58442.27
12-Dec-22,Brahmaputra,Clean 100ml,250,10,0,10,940,9400,27274.83
11-Dec-22,Brahmaputra,Clean 100ml,250,50,3,53,940,47000,132652.32
18-Oct-22,Brahmaputra,Clean 100ml,250,20,1,21,940,18800,44439.81
4-Oct-22,Brahmaputra,Fresmin F 10kg,2178,1,0,1,4595,4595,58442.27
28-Sep-22,Brahmaputra,Clean 100ml,250,9,0,9,940,8460,26130.21
25-Sep-22,Brahmaputra,Clean 100ml,250,20,1,21,940,18800,46238.53
21-Sep-22,Brahmaputra,Clean 100ml,250,5,0,5,940,4700,31747.84
20-Sep-22,Brahmaputra,Clean 100ml,250,60,5,65,940,56400,136129.58
20-Sep-22,Brahmaputra,Clean 100ml,250,20,1,21,940,18800,35590.73
17-Sep-22,Brahmaputra,Clean 100ml,250,25,1,26,940,23500,92327.94
14-Sep-22,Brahmaputra,Clean 100ml,250,25,1,26,940,23500,16732.52
13-Sep-22,Brahmaputra,Clean 100ml,250,1,0,1,940,940,86662.15
13-Sep-22,Brahmaputra,Clean 100ml,250,25,0,25,940,23500,86662.15
13-Sep-22,Brahmaputra,Clean 100ml,250,36,5,41,940,33840,86662.15
13-Sep-22,Brahmaputra,Clean 100ml,250,1,0,1,940,940,32294.06
13-Sep-22,Brahmaputra,Clean 100ml,250,2,0,2,940,1880,8920.83
12-Sep-22,Brahmaputra,Clean 100ml,250,20,1,21,940,18800,31217.98
8-Sep-22,Brahmaputra,Clean 100ml,250,5,0,5,940,4700,47356.9
7-Sep-22,Brahmaputra,Clean 100ml,250,40,3,43,940,37600,70366.48
6-Sep-22,Brahmaputra,Clean 100ml,250,1,0,1,940,940,3420.94
6-Sep-22,Brahmaputra,Clean 100ml,250,10,0,10,940,9400,28520.47
6-Sep-22,Brahmaputra,Clean 100ml,250,5,0,5,940,4700,13322.33
5-Sep-22,Brahmaputra,Clean 100ml,250,5,0,5,940,4700,12013.21
5-Sep-22,Brahmaputra,Clean 100ml,250,5,0,5,940,4700,186021.36
29-Aug-22,Brahmaputra,Clean 100ml,250,12,0,12,940,11280,22387.66
25-Aug-22,Brahmaputra,Clean 100ml,250,20,1,21,940,18800,19134.96
25-Aug-22,Brahmaputra,Clean 100ml,250,20,1,21,940,18800,35112.25
25-Aug-22,Brahmaputra,Clean 100ml,250,20,1,21,940,18800,51556.19
24-Aug-22,Brahmaputra,Clean 100ml,250,5,0,5,940,4700,37490.7
24-Aug-22,Brahmaputra,Clean 100ml,250,40,3,43,940,37600,38531.48
24-Aug-22,Brahmaputra,Clean 100ml,250,10,0,10,940,9400,20700.96
23-Aug-22,Brahmaputra,Clean 100ml,250,40,3,43,940,37600,58340.12
23-Aug-22,Brahmaputra,Fresmin F 10kg,11,1,0,1,4595,4595,136129.58
23-Aug-22,Brahmaputra,Clean 100ml,250,5,0,5,940,4700,8920.83
23-Aug-22,Brahmaputra,Clean 100ml,250,3,0,3,940,2820,8290.65
22-Aug-22,Brahmaputra,Clean 100ml,250,60,5,65,940,56400,223788.7
22-Aug-22,Brahmaputra,Clean 100ml,250,20,1,21,940,18800,20618.33
3-Aug-22,Brahmaputra,Clean 100ml,250,5,0,5,940,4700,26130.21
3-Aug-22,Brahmaputra,Clean 100ml,250,20,1,21,940,18800,35590.73
3-Aug-22,Brahmaputra,Clean 100ml,250,20,1,21,940,18800,31217.98
2-Aug-22,Brahmaputra,Clean 100ml,250,20,1,21,940,18800,58340.12
2-Aug-22,Brahmaputra,Clean 100ml,250,20,1,21,940,18800,24685.13
31-Jul-22,Brahmaputra,Clean 100ml,250,20,1,21,940,18800,123151.84
31-Jul-22,Brahmaputra,Clean 100ml,250,40,3,43,940,37600,95654.72
31-Jul-22,Brahmaputra,Clean 100ml,250,20,1,21,940,18800,35669.3
31-Jul-22,Brahmaputra,Clean 100ml,250,20,1,21,940,18800,67309.74
31-Jul-22,Brahmaputra,Clean 100ml,250,20,1,21,940,18800,92980.71
31-Jul-22,Brahmaputra,Clean 100ml,250,60,5,65,940,56400,56329.79
31-Jul-22,Brahmaputra,Clean 100ml,250,25,1,26,940,23500,20470.69
31-Jul-22,Brahmaputra,Clean 100ml,250,20,1,21,940,18800,223788.7
31-Jul-22,Brahmaputra,Clean 100ml,250,20,1,21,940,18800,27274.83
31-Jul-22,Brahmaputra,Clean 100ml,250,20,1,21,940,18800,136129.58
31-Jul-22,Brahmaputra,Clean 100ml,250,20,1,21,940,18800,32294.06
31-Jul-22,Brahmaputra,Clean 100ml,250,60,5,65,940,56400,44439.81
27-Jul-22,Brahmaputra,Clean 100ml,250,3,0,3,940,2820,8920.83
27-Jul-22,Brahmaputra,Clean 100ml,250,100,11,111,940,94000,46238.53
26-Jul-22,Brahmaputra,Clean 100ml,250,1,0,1,940,940,16537.87
26-Jul-22,Brahmaputra,Clean 100ml,250,20,1,21,940,18800,44658.13
26-Jul-22,Brahmaputra,Clean 100ml,250,100,11,111,940,94000,27538.23
26-Jul-22,Brahmaputra,Clean 100ml,250,20,1,21,940,18800,27452.73
27-Apr-22,Brahmaputra,Clean 100ml,250,1,0,1,940,940,6613.81
26-Apr-22,Brahmaputra,Clean 100ml,250,100,12,112,940,94000,125931.38
26-Apr-22,Brahmaputra,Clean 100ml,250,20,1,21,940,18800,106535.84
26-Apr-22,Brahmaputra,Clean 100ml,250,20,1,21,940,18800,16708.05
26-Apr-22,Brahmaputra,Clean 100ml,1,19,0,19,940,17860,90012.92
26-Apr-22,Brahmaputra,Clean 100ml,250,1,1,2,940,940,90012.92
26-Apr-22,Brahmaputra,Clean 100ml,250,40,3,43,940,37600,136129.58
26-Apr-22,Brahmaputra,Clean 100ml,1,20,1,21,940,18800,123151.84
26-Apr-22,Brahmaputra,Clean 100ml,1,3,0,3,940,2820,8920.83
26-Apr-22,Brahmaputra,Clean 100ml,1,40,3,43,940,37600,70366.48
26-Apr-22,Brahmaputra,Clean 100ml,1,20,1,21,940,18800,35669.3
26-Apr-22,Brahmaputra,Clean 100ml,1,20,1,21,940,18800,92980.71
26-Apr-22,Brahmaputra,Clean 100ml,1,20,1,21,940,18800,27538.23
26-Apr-22,Brahmaputra,Clean 100ml,1,20,1,21,940,18800,10427.83
25-Apr-22,Brahmaputra,Clean 100ml,1,10,0,10,940,9400,22387.66
23-Apr-22,Brahmaputra,Clean 100ml,1,20,1,21,940,18800,86662.15
23-Apr-22,Brahmaputra,Clean 100ml,250,20,1,21,940,18800,44439.81
23-Apr-22,Brahmaputra,Clean 100ml,1,20,1,21,940,18800,32294.06
23-Apr-22,Brahmaputra,Clean 100ml,1,20,1,21,940,18800,28520.47
23-Apr-22,Brahmaputra,Clean 100ml,1,20,1,21,940,18800,26401.93
23-Apr-22,Brahmaputra,Clean 100ml,1,40,3,43,940,37600,56329.79
23-Apr-22,Brahmaputra,Clean 100ml,1,2,0,2,940,1880,16537.87
4-Oct-23,Corporate,Gentech - P.S (20 LTr.),0,10,0,10,11700,117000,458106.68
19-Sep-23,Corporate,Clean 100ml,250,4,0,4,940,3760,35855.06
17-Sep-23,Corporate,Clean 100ml,250,8,0,8,940,7520,35855.06
17-Sep-23,Corporate,Clean 100ml,250,1,0,1,940,940,35855.06
17-Sep-23,Corporate,Clean 100ml,250,1,0,1,940,940,35855.06
21-Aug-23,Corporate,Gentech - P.S (20 LTr.),0,5,0,5,11700,58500,458106.68
3-Aug-23,Corporate,Vivapond Plus (1kg),5,20,0,20,6600,132000,458106.68
17-Jun-23,Corporate,Viusid Aqua 500ml,1,4,0,4,2750,11000,507613.68
15-Jun-23,Corporate,Viusid Aqua 500ml,1,10,0,10,2750,27500,507613.68
13-Jun-23,Corporate,Viusid Aqua 500ml,1,10,0,10,2750,27500,458106.68
17-Jun-23,Corporate,Viusid Aqua 500ml,1,0,0,0,2750,0,458106.68
8-Jun-23,Corporate,Viusid Aqua 500ml,1,10,0,10,2750,27500,458106.68
30-May-23,Corporate,Viusid Aqua 500ml,1,2,0,2,2750,5500,4377.13
27-May-23,Corporate,Viusid Aqua 500ml,1,10,0,10,2750,27500,507613.68
24-May-23,Corporate,Vivabond (5Ltr.),1,1,0,1,2350,2350,23593.51
16-May-23,Corporate,Viusid Aqua 500ml,1,4,0,4,2750,11000,23593.51
4-May-23,Corporate,Viusid Aqua 500ml,1,10,0,10,2750,27500,507613.68
4-May-23,Corporate,Viusid Aqua 500ml,1,60,0,60,2750,165000,46885.32
2-May-23,Corporate,Viusid Aqua 500ml,1,30,0,30,2750,82500,458106.68
2-May-23,Corporate,Vivapond Plus (1kg),1,10,0,10,6600,66000,458106.68
27-May-23,Corporate,Viusid Aqua 500ml,1,0,0,0,2750,0,458106.68
30-Apr-23,Corporate,Viusid Aqua 500ml,1,4,0,4,2750,11000,23593.51
8-Apr-23,Corporate,Vivapond Plus (1kg),1,20,0,20,6600,132000,458106.68
30-Mar-23,Corporate,Vivapond Plus (1kg),1,20,0,20,6600,132000,46885.32
27-Mar-23,Corporate,Clean 100ml,250,9,0,9,940,8460,8281
27-Mar-23,Corporate,Clean 100ml,250,1,0,1,940,940,8281
25-Mar-23,Corporate,Viusid Aqua 500ml,1,10,0,10,2750,27500,507613.68
18-Jan-23,Corporate,Clean 100ml,250,10,0,10,940,9400,8281
12-Nov-22,Corporate,Clean 100ml,250,4,0,4,940,3760,3760
30-Oct-22,Corporate,Clean 100ml,250,2,0,2,940,1880,4377.13
26-Oct-22,Corporate,Gentech - P.S (20 LTr.),0,5,0,5,11700,58500,458106.68
25-Oct-22,Corporate,Gentech - P.S (20 LTr.),0,10,0,10,11700,117000,458106.68
3-Oct-22,Corporate,Clean 100ml,250,1,0,1,940,940,35855.06
29-Sep-22,Corporate,Gentech - P.S (20 LTr.),0,5,0,5,11700,58500,281865.51
17-Oct-22,Corporate,Gentech - P.S (20 LTr.),0,0,0,0,11700,0,281865.51
29-Sep-22,Corporate,Gentech - P.S (20 LTr.),0,5,0,5,11700,58500,458106.68
10-Sep-22,Corporate,Clean 100ml,250,1,0,1,940,940,35855.06
18-Jul-22,Corporate,Fresmin F 10kg,11,2,0,2,4595,9190,4377.13
9-May-22,Corporate,Stable Bleaching Powder 25kg,44,12,0,12,1575,18900,507613.68
16-Mar-22,Corporate,K1 Bio Filter Media,850,140,0,140,985,137900,133763
23-Oct-23,Gumti,Clean 100ml,250,20,1,21,940,18800,52584.81
19-Oct-23,Gumti,Clean 100ml,250,20,1,21,940,18800,37798.57
18-Oct-23,Gumti,Clean 100ml,250,65,5,70,940,61100,36274.7
14-Oct-23,Gumti,Clean 100ml,250,50,4,54,940,47000,40973.09
11-Oct-23,Gumti,Clean 100ml,250,42,3,45,940,39480,25981.56
11-Oct-23,Gumti,Clean 100ml,250,45,3,48,940,42300,54340.45
8-Oct-23,Gumti,Clean 100ml,250,20,1,21,940,18800,44851.77
7-Oct-23,Gumti,Clean 100ml,250,40,3,43,940,37600,39962.08
7-Oct-23,Gumti,Clean 100ml,250,1,0,1,940,940,39962.08
7-Oct-23,Gumti,Clean 100ml,250,9,0,9,940,8460,39962.08
21-Sep-23,Gumti,Clean 100ml,250,157,0,157,940,147580,99174.18
21-Sep-23,Gumti,Clean 100ml,250,43,24,67,940,40420,99174.18
7-Sep-23,Gumti,Clean 100ml,250,20,1,21,940,18800,45489.02
7-Sep-23,Gumti,Clean 100ml,250,40,3,43,940,37600,90124.37
7-Sep-23,Gumti,Clean 100ml,250,11,0,11,940,10340,87394.67
7-Sep-23,Gumti,Clean 100ml,250,40,3,43,940,37600,48792.09
6-Sep-23,Gumti,Clean 100ml,250,20,1,21,940,18800,30308.83
6-Sep-23,Gumti,Clean 100ml,250,40,3,43,940,37600,38978.26
5-Sep-23,Gumti,Clean 100ml,250,60,5,65,940,56400,65925.32
3-Sep-23,Gumti,Clean 100ml,250,20,1,21,940,18800,34084.78
3-Sep-23,Gumti,Clean 100ml,250,3,0,3,940,2820,30150.19
3-Sep-23,Gumti,Clean 100ml,250,4,0,4,940,3760,30150.19
3-Sep-23,Gumti,Clean 100ml,250,13,1,14,940,12220,30150.19
31-Aug-23,Gumti,Clean 100ml,250,50,0,50,940,47000,37798.57
31-Aug-23,Gumti,Clean 100ml,250,2,4,6,940,1880,37798.57
30-Aug-23,Gumti,Clean 100ml,250,20,1,21,940,18800,34615.59
26-Aug-23,Gumti,Clean 100ml,250,17,0,17,940,15980,87394.67
24-Aug-23,Gumti,Clean 100ml,250,10,0,10,940,9400,23773.11
24-Aug-23,Gumti,Clean 100ml,250,25,1,26,940,23500,87394.67
16-Aug-23,Gumti,Clean 100ml,250,4,0,4,940,3760,87394.67
6-Aug-23,Gumti,Clean 100ml,250,40,3,43,940,37600,32302.04
3-Aug-23,Gumti,Clean 100ml,250,20,1,21,940,18800,25981.56
30-Jul-23,Gumti,Clean 100ml,250,20,1,21,940,18800,30150.19
29-Jul-23,Gumti,Clean 100ml,250,50,3,53,940,47000,39962.08
23-Jul-23,Gumti,Clean 100ml,250,100,10,110,940,94000,63194.94
23-Jul-23,Gumti,Clean 100ml,250,50,4,54,940,47000,37798.57
20-Jul-23,Gumti,Clean 100ml,250,20,1,21,940,18800,24954.2
19-Jul-23,Gumti,Clean 100ml,250,100,0,100,940,94000,72312.64
19-Jul-23,Gumti,Clean 100ml,250,0,10,10,940,0,72312.64
19-Jul-23,Gumti,Clean 100ml,250,0,6,6,940,0,72312.64
19-Jul-23,Gumti,Clean 100ml,250,0,7,7,940,0,72312.64
19-Jul-23,Gumti,Clean 100ml,250,0,2,2,940,0,72312.64
17-Jul-23,Gumti,Clean 100ml,250,20,1,21,940,18800,17191.83
10-Jul-23,Gumti,Clean 100ml,250,40,3,43,940,37600,45489.02
9-Jul-23,Gumti,Clean 100ml,250,60,5,65,940,56400,65925.32
6-Jul-23,Gumti,Clean 100ml,250,20,1,21,940,18800,26223.35
19-Jun-23,Gumti,Clean 100ml,250,65,5,70,940,61100,52438.55
14-Jun-23,Gumti,Clean 100ml,250,20,1,21,940,18800,90124.37
11-Jun-23,Gumti,Clean 100ml,250,20,1,21,940,18800,54334
5-Jun-23,Gumti,Clean 100ml,250,100,10,110,940,94000,99174.18
24-May-23,Gumti,Clean 100ml,250,100,10,110,940,94000,52584.81
22-May-23,Gumti,Clean 100ml,250,30,0,30,940,28200,35603.22
22-May-23,Gumti,Clean 100ml,250,10,3,13,940,9400,35603.22
22-May-23,Gumti,Clean 100ml,250,65,5,70,940,61100,33208.17
18-May-23,Gumti,Clean 100ml,250,20,1,21,940,18800,30308.83
17-May-23,Gumti,Clean 100ml,250,20,1,21,940,18800,39962.08
11-May-23,Gumti,Clean 100ml,250,100,0,100,940,94000,68059.97
11-May-23,Gumti,Clean 100ml,250,5,11,16,940,4700,68059.97
7-May-23,Gumti,Clean 100ml,250,65,6,71,940,61100,48792.09
6-May-23,Gumti,Clean 100ml,250,20,1,21,940,18800,32302.04
6-May-23,Gumti,Clean 100ml,250,20,1,21,940,18800,30150.19
4-May-23,Gumti,Clean 100ml,250,20,1,21,940,18800,12605.63
2-May-23,Gumti,Clean 100ml,250,40,3,43,940,37600,36274.7
11-Apr-23,Gumti,Clean 100ml,250,45,3,48,940,42300,35007.41
6-Apr-23,Gumti,Clean 100ml,250,20,1,21,940,18800,44851.77
6-Apr-23,Gumti,Clean 100ml,250,60,5,65,940,56400,65925.32
5-Apr-23,Gumti,Clean 100ml,250,20,1,21,940,18800,10704.96
2-Apr-23,Gumti,Clean 100ml,250,40,3,43,940,37600,38950.76
27-Mar-23,Gumti,Clean 100ml,250,10,0,10,940,9400,24954.2
21-Mar-23,Gumti,Clean 100ml,250,43,3,46,940,40420,45489.02
20-Mar-23,Gumti,Clean 100ml,250,45,3,48,940,42300,36274.7
18-Mar-23,Gumti,Clean 100ml,250,6,0,6,940,5640,10704.96
7-Mar-23,Gumti,Clean 100ml,250,19,0,19,940,17860,39962.08
7-Mar-23,Gumti,Clean 100ml,250,1,1,2,940,940,39962.08
7-Mar-23,Gumti,Clean 100ml,250,20,1,21,940,18800,34084.78
7-Mar-23,Gumti,Clean 100ml,250,20,1,21,940,18800,30150.19
7-Mar-23,Gumti,Clean 100ml,250,100,8,108,940,94000,37798.57
7-Mar-23,Gumti,Clean 100ml,250,20,1,21,940,18800,25981.56
7-Mar-23,Gumti,Clean 100ml,250,20,1,21,940,18800,19033.26
7-Mar-23,Gumti,Clean 100ml,250,20,1,21,940,18800,26223.35
7-Mar-23,Gumti,Clean 100ml,250,50,3,53,940,47000,48792.09
4-Mar-23,Gumti,Clean 100ml,250,20,1,21,940,18800,65925.32
28-Feb-23,Gumti,Clean 100ml,250,14,0,14,940,13160,22095.98
28-Feb-23,Gumti,Clean 100ml,250,6,1,7,940,5640,22095.98
26-Feb-23,Gumti,Clean 100ml,250,3,0,3,940,2820,14363.74
19-Feb-23,Gumti,Clean 100ml,250,62,5,67,940,58280,38978.26
18-Feb-23,Gumti,Clean 100ml,250,200,23,223,940,188000,145026
12-Feb-23,Gumti,Clean 100ml,250,20,1,21,940,18800,48792.09
7-Feb-23,Gumti,Clean 100ml,250,42,3,45,940,39480,40973.09
6-Feb-23,Gumti,Clean 100ml,250,42,3,45,940,39480,36912.45
6-Feb-23,Gumti,Clean 100ml,250,20,1,21,940,18800,65925.32
2-Feb-23,Gumti,Clean 100ml,250,20,1,21,940,18800,54340.45
2-Feb-23,Gumti,Clean 100ml,250,20,1,21,940,18800,34084.78
29-Jan-23,Gumti,Clean 100ml,250,100,11,111,940,94000,74443.34
29-Jan-23,Gumti,Clean 100ml,250,20,1,21,940,18800,30150.19
29-Jan-23,Gumti,Clean 100ml,250,40,3,43,940,37600,34615.59
25-Jan-23,Gumti,Clean 100ml,250,50,4,54,940,47000,35321.91
23-Jan-23,Gumti,Clean 100ml,250,50,0,50,940,47000,63194.94
22-Jan-23,Gumti,Clean 100ml,250,20,1,21,940,18800,65925.32
19-Jan-23,Gumti,Clean 100ml,250,40,3,43,940,37600,45489.02
19-Jan-23,Gumti,Clean 100ml,250,20,1,21,940,18800,32302.04
15-Jan-23,Gumti,Clean 100ml,250,20,1,21,940,18800,74443.34
10-Jan-23,Gumti,Clean 100ml,250,60,5,65,940,56400,37798.57
8-Jan-23,Gumti,Clean 100ml,250,30,0,30,940,28200,35007.41
8-Jan-23,Gumti,Clean 100ml,250,20,1,21,940,18800,45489.02
4-Jan-23,Gumti,Clean 100ml,250,2,0,2,940,1880,74443.34
4-Jan-23,Gumti,Clean 100ml,250,20,0,20,940,18800,39962.08
3-Jan-23,Gumti,Clean 100ml,250,20,1,21,940,18800,17191.83
1-Jan-23,Gumti,Clean 100ml,250,5,0,5,940,4700,12605.63
28-Dec-22,Gumti,Clean 100ml,250,100,10,110,940,94000,74443.34
27-Dec-22,Gumti,Clean 100ml,250,100,10,110,940,94000,91098.22
27-Dec-22,Gumti,Clean 100ml,250,100,10,110,940,94000,68059.97
26-Dec-22,Gumti,Clean 100ml,250,20,1,21,940,18800,44851.77
21-Dec-22,Gumti,Clean 100ml,250,20,1,21,940,18800,48792.09
20-Dec-22,Gumti,Clean 100ml,250,40,3,43,940,37600,33208.17
13-Dec-22,Gumti,Clean 100ml,250,100,10,110,940,94000,52584.81
13-Dec-22,Gumti,Clean 100ml,250,100,10,110,940,94000,72312.64
13-Dec-22,Gumti,Clean 100ml,250,20,1,21,940,18800,34084.78
13-Dec-22,Gumti,Clean 100ml,250,20,1,21,940,18800,36912.45
24-Nov-22,Gumti,Clean 100ml,250,16,0,16,940,15040,40973.09
24-Nov-22,Gumti,Clean 100ml,250,24,1,25,940,22560,73092.84
24-Nov-22,Gumti,Clean 100ml,250,80,7,87,940,75200,63194.94
24-Nov-22,Gumti,Clean 100ml,250,70,6,76,940,65800,74443.34
19-Nov-22,Gumti,Clean 100ml,250,20,0,20,940,18800,36912.45
19-Nov-22,Gumti,Clean 100ml,250,0,1,1,940,0,36912.45
13-Nov-22,Gumti,Clean 100ml,250,6,0,6,940,5640,16099.07
13-Nov-22,Gumti,Clean 100ml,250,4,0,4,940,3760,16099.07
6-Nov-22,Gumti,Clean 100ml,250,60,5,65,940,56400,99174.18
1-Nov-22,Gumti,Clean 100ml,250,5,0,5,940,4700,11686.4
27-Sep-22,Gumti,Clean 100ml,250,38,0,38,940,35720,52438.55
27-Sep-22,Gumti,Clean 100ml,250,2,3,5,940,1880,52438.55
26-Sep-22,Gumti,Clean 100ml,250,60,0,60,940,56400,37798.57
26-Sep-22,Gumti,Clean 100ml,250,0,5,5,940,0,37798.57
24-Sep-22,Gumti,Clean 100ml,250,51,0,51,940,47940,99174.18
24-Sep-22,Gumti,Clean 100ml,250,9,5,14,940,8460,99174.18
22-Sep-22,Gumti,Clean 100ml,250,24,1,25,940,22560,74443.34
18-Sep-22,Gumti,Clean 100ml,250,6,0,6,940,5640,33208.17
11-Sep-22,Gumti,Clean 100ml,250,40,3,43,940,37600,21278.59
7-Sep-22,Gumti,Clean 100ml,250,7,0,7,940,6580,39962.08
7-Sep-22,Gumti,Clean 100ml,250,3,0,3,940,2820,39962.08
6-Sep-22,Gumti,Clean 100ml,250,40,3,43,940,37600,52584.81
5-Sep-22,Gumti,Clean 100ml,250,5,0,5,940,4700,9587.19
4-Sep-22,Gumti,Clean 100ml,250,13,0,13,940,12220,30150.19
4-Sep-22,Gumti,Clean 100ml,250,7,1,8,940,6580,30150.19
3-Sep-22,Gumti,Clean 100ml,250,20,1,21,940,18800,72312.64
3-Sep-22,Gumti,Clean 100ml,250,20,1,21,940,18800,65925.32
3-Sep-22,Gumti,Clean 100ml,250,50,4,54,940,47000,37798.57
31-Aug-22,Gumti,Clean 100ml,250,40,0,40,940,37600,63194.94
28-Aug-22,Gumti,Clean 100ml,250,1,0,1,940,940,5931.3
25-Aug-22,Gumti,Clean 100ml,250,5,0,5,940,4700,16490
25-Aug-22,Gumti,Clean 100ml,250,10,0,10,940,9400,48792.09
25-Aug-22,Gumti,Clean 100ml,250,20,1,21,940,18800,99174.18
25-Aug-22,Gumti,Clean 100ml,250,40,3,43,940,37600,68389.71
25-Aug-22,Gumti,Clean 100ml,250,100,11,111,940,94000,68059.97
24-Aug-22,Gumti,Clean 100ml,250,3,0,3,940,2820,48792.09
22-Aug-22,Gumti,Clean 100ml,250,60,5,65,940,56400,38950.76
22-Aug-22,Gumti,Clean 100ml,250,20,1,21,940,18800,34084.78
21-Aug-22,Gumti,Clean 100ml,250,20,1,21,940,18800,45489.02
21-Aug-22,Gumti,Clean 100ml,250,40,3,43,940,37600,32367.35
21-Aug-22,Gumti,Clean 100ml,250,20,1,21,940,18800,37798.57
20-Aug-22,Gumti,Clean 100ml,250,10,0,10,940,9400,48792.09
17-Aug-22,Gumti,Clean 100ml,250,15,0,15,940,14100,16099.07
7-Aug-22,Gumti,Clean 100ml,250,5,0,5,940,4700,34084.78
7-Aug-22,Gumti,Clean 100ml,250,5,0,5,940,4700,34615.59
7-Aug-22,Gumti,Clean 100ml,250,5,0,5,940,4700,44851.77
4-Aug-22,Gumti,Clean 100ml,250,6,0,6,940,5640,65925.32
4-Aug-22,Gumti,Clean 100ml,250,5,0,5,940,4700,30150.19
2-Aug-22,Gumti,Clean 100ml,250,25,1,26,940,23500,99174.18
1-Aug-22,Gumti,Clean 100ml,250,20,1,21,940,18800,40973.09
1-Aug-22,Gumti,Clean 100ml,250,100,10,110,940,94000,73092.84
31-Jul-22,Gumti,Clean 100ml,250,2,0,2,940,1880,14491.8
28-Jul-22,Gumti,Clean 100ml,250,4,0,4,940,3760,4077.63
28-Jul-22,Gumti,Clean 100ml,250,3,0,3,940,2820,3212.9
28-Jul-22,Gumti,Clean 100ml,250,5,0,5,940,4700,34084.78
28-Jul-22,Gumti,Clean 100ml,250,10,0,10,940,9400,48792.09
27-Jul-22,Gumti,Clean 100ml,250,20,1,21,940,18800,17856.07
27-Jul-22,Gumti,Clean 100ml,250,40,3,43,940,37600,36274.7
27-Jul-22,Gumti,Clean 100ml,250,20,1,21,940,18800,52438.55
26-Jul-22,Gumti,Clean 100ml,250,5,0,5,940,4700,33208.17
26-Jul-22,Gumti,Clean 100ml,250,40,3,43,940,37600,33208.17
25-Jul-22,Gumti,Clean 100ml,250,40,3,43,940,37600,52584.81
7-Jul-22,Gumti,Clean 100ml,1,6,0,6,940,5640,52438.55
15-May-22,Gumti,Clean 100ml,1,3,0,3,940,2820,65925.32
8-May-22,Gumti,Clean 100ml,250,5,0,5,940,4700,65925.32
28-Apr-22,Gumti,Clean 100ml,250,100,12,112,940,94000,37798.57
27-Apr-22,Gumti,Clean 100ml,1,10,0,10,940,9400,44851.77
27-Apr-22,Gumti,Clean 100ml,1,60,0,60,940,56400,38978.26
27-Apr-22,Gumti,Clean 100ml,1,0,5,5,940,0,38978.26
26-Apr-22,Gumti,Clean 100ml,1,20,1,21,940,18800,33208.17
26-Apr-22,Gumti,Clean 100ml,1,10,0,10,940,9400,39962.08
25-Apr-22,Gumti,Clean 100ml,1,6,0,6,940,5640,6203.3
24-Apr-22,Gumti,Clean 100ml,1,100,12,112,940,94000,68059.97
24-Apr-22,Gumti,Clean 100ml,1,100,12,112,940,94000,91098.22
23-Apr-22,Gumti,Clean 100ml,1,20,1,21,940,18800,26223.35
25-Oct-23,Karatoa,Clean 100ml,250,5,0,5,940,4700,12769.91
19-Oct-23,Karatoa,Clean 100ml,250,20,1,21,940,18800,9716.16
18-Oct-23,Karatoa,Clean 100ml,250,150,1,151,940,141000,46446.29
18-Oct-23,Karatoa,Clean 100ml,250,0,16,16,940,0,46446.29
16-Oct-23,Karatoa,Clean 100ml,250,20,1,21,940,18800,33469.75
10-Oct-23,Karatoa,Clean 100ml,250,40,0,40,940,37600,55814.68
10-Oct-23,Karatoa,Clean 100ml,250,0,3,3,940,0,55814.68
7-Oct-23,Karatoa,Clean 100ml,250,20,1,21,940,18800,17187.23
4-Oct-23,Karatoa,Clean 100ml,250,60,0,60,940,56400,19585.23
4-Oct-23,Karatoa,Clean 100ml,250,0,3,3,940,0,19585.23
4-Oct-23,Karatoa,Clean 100ml,250,0,2,2,940,0,19585.23
3-Oct-23,Karatoa,Clean 100ml,250,7,0,7,940,6580,8296.2
1-Oct-23,Karatoa,Clean 100ml,250,9,0,9,940,8460,9743.27
23-Sep-23,Karatoa,Clean 100ml,250,20,0,20,940,18800,18964.46
23-Sep-23,Karatoa,Clean 100ml,250,0,1,1,940,0,18964.46
19-Sep-23,Karatoa,Clean 100ml,250,2,0,2,940,1880,9743.27
12-Sep-23,Karatoa,Clean 100ml,250,20,0,20,940,18800,80970.66
12-Sep-23,Karatoa,Clean 100ml,250,0,1,1,940,0,80970.66
12-Sep-23,Karatoa,Clean 100ml,250,40,3,43,940,37600,84964.42
7-Sep-23,Karatoa,Clean 100ml,250,20,1,21,940,18800,22910.08
7-Sep-23,Karatoa,Clean 100ml,250,40,3,43,940,37600,26196.34
7-Sep-23,Karatoa,Clean 100ml,250,100,0,100,940,94000,91434.24
7-Sep-23,Karatoa,Clean 100ml,250,0,3,3,940,0,91434.24
7-Sep-23,Karatoa,Clean 100ml,250,0,8,8,940,0,91434.24
7-Sep-23,Karatoa,Clean 100ml,250,100,6,106,940,94000,189769.71
5-Sep-23,Karatoa,Clean 100ml,250,50,0,50,940,47000,127263.04
5-Sep-23,Karatoa,Clean 100ml,250,0,6,6,940,0,127263.04
5-Sep-23,Karatoa,Clean 100ml,250,40,3,43,940,37600,49090.35
4-Sep-23,Karatoa,Clean 100ml,250,100,0,100,940,94000,46446.29
4-Sep-23,Karatoa,Clean 100ml,250,0,11,11,940,0,46446.29
24-Aug-23,Karatoa,Clean 100ml,250,10,0,10,940,9400,19585.23
23-Aug-23,Karatoa,Clean 100ml,250,20,1,21,940,18800,33469.75
20-Aug-23,Karatoa,Clean 100ml,250,100,11,111,940,94000,60295.99
20-Aug-23,Karatoa,Clean 100ml,250,20,1,21,940,18800,84964.42
17-Aug-23,Karatoa,Clean 100ml,250,20,1,21,940,18800,16158.2
17-Aug-23,Karatoa,Clean 100ml,250,5,0,5,940,4700,11131.02
17-Aug-23,Karatoa,Clean 100ml,250,200,24,224,940,188000,86310.27
7-Aug-23,Karatoa,Clean 100ml,250,20,1,21,940,18800,36433.14
7-Aug-23,Karatoa,Clean 100ml,250,6,0,6,940,5640,6807.15
7-Aug-23,Karatoa,Clean 100ml,250,50,2,52,940,47000,189769.71
6-Aug-23,Karatoa,Clean 100ml,250,20,1,21,940,18800,17881.74
3-Aug-23,Karatoa,Clean 100ml,250,70,6,76,940,65800,84964.42
3-Aug-23,Karatoa,Clean 100ml,250,6,0,6,940,5640,7352.21
3-Aug-23,Karatoa,Clean 100ml,250,60,5,65,940,56400,96102
1-Aug-23,Karatoa,Clean 100ml,250,1,0,1,940,940,11705.27
31-Jul-23,Karatoa,Clean 100ml,250,20,1,21,940,18800,37355.52
26-Jul-23,Karatoa,Clean 100ml,250,100,10,110,940,94000,149803.5
26-Jul-23,Karatoa,Clean 100ml,250,0,2,2,940,0,149803.5
26-Jul-23,Karatoa,Clean 100ml,250,40,3,43,940,37600,15621.22
24-Jul-23,Karatoa,Clean 100ml,250,0,1,1,940,0,22057.33
24-Jul-23,Karatoa,Clean 100ml,250,20,0,20,940,18800,22057.33
22-Jul-23,Karatoa,Clean 100ml,250,20,0,20,940,18800,127263.04
22-Jul-23,Karatoa,Clean 100ml,250,0,2,2,940,0,127263.04
22-Jul-23,Karatoa,Clean 100ml,250,6,0,6,940,5640,6807.15
20-Jul-23,Karatoa,Clean 100ml,250,20,1,21,940,18800,30506.98
19-Jul-23,Karatoa,Clean 100ml,250,200,22,222,940,188000,54261.78
17-Jul-23,Karatoa,Clean 100ml,250,6,0,6,940,5640,6807.15
13-Jul-23,Karatoa,Clean 100ml,250,25,0,25,940,23500,27348.38
11-Jul-23,Karatoa,Clean 100ml,250,20,0,20,940,18800,17881.74
11-Jul-23,Karatoa,Clean 100ml,250,0,1,1,940,0,17881.74
10-Jul-23,Karatoa,Clean 100ml,250,100,10,110,940,94000,91434.24
9-Jul-23,Karatoa,Clean 100ml,250,20,1,21,940,18800,33469.75
26-Jun-23,Karatoa,Clean 100ml,250,12,0,12,940,11280,14080.36
25-Jun-23,Karatoa,Clean 100ml,250,50,3,53,940,47000,189769.71
25-Jun-23,Karatoa,Clean 100ml,250,20,1,21,940,18800,37355.52
15-Jun-23,Karatoa,Clean 100ml,250,5,0,5,940,4700,19585.23
10-Jun-23,Karatoa,Clean 100ml,250,5,0,5,940,4700,15445.05
8-Jun-23,Karatoa,Clean 100ml,250,20,1,21,940,18800,30506.98
4-Jun-23,Karatoa,Clean 100ml,250,60,1,61,940,56400,96102
4-Jun-23,Karatoa,Clean 100ml,250,0,4,4,940,0,96102
31-May-23,Karatoa,Clean 100ml,250,20,1,21,940,18800,9716.16
31-May-23,Karatoa,Clean 100ml,250,25,0,25,940,23500,27348.38
30-May-23,Karatoa,Clean 100ml,250,20,1,21,940,18800,15263.35
30-May-23,Karatoa,Clean 100ml,250,20,1,21,940,18800,26196.34
29-May-23,Karatoa,Clean 100ml,250,100,10,110,940,94000,91434.24
27-May-23,Karatoa,Clean 100ml,250,20,1,21,940,18800,33469.75
27-May-23,Karatoa,Clean 100ml,250,20,1,21,940,18800,17881.74
23-May-23,Karatoa,Clean 100ml,250,20,1,21,940,18800,16158.2
23-May-23,Karatoa,Clean 100ml,250,18,0,18,940,16920,22057.33
23-May-23,Karatoa,Clean 100ml,250,2,1,3,940,1880,22057.33
23-May-23,Karatoa,Clean 100ml,250,100,11,111,940,94000,46446.29
20-May-23,Karatoa,Clean 100ml,250,20,1,21,940,18800,33469.75
20-May-23,Karatoa,Clean 100ml,250,100,11,111,940,94000,60295.99
18-May-23,Karatoa,Clean 100ml,250,20,1,21,940,18800,44204.63
14-May-23,Karatoa,Clean 100ml,250,4,0,4,940,3760,11705.27
26-Apr-23,Karatoa,Clean 100ml,250,40,1,41,940,37600,96102
26-Apr-23,Karatoa,Clean 100ml,250,0,2,2,940,0,96102
15-Apr-23,Karatoa,Clean 100ml,250,8,0,8,940,7520,6807.15
11-Apr-23,Karatoa,Clean 100ml,250,20,0,20,940,18800,17685.16
11-Apr-23,Karatoa,Clean 100ml,250,0,1,1,940,0,17685.16
9-Apr-23,Karatoa,Clean 100ml,250,20,0,20,940,18800,29581.46
9-Apr-23,Karatoa,Clean 100ml,250,0,1,1,940,0,29581.46
2-Apr-23,Karatoa,Clean 100ml,250,6,0,6,940,5640,6807.15
1-Apr-23,Karatoa,Clean 100ml,250,12,0,12,940,11280,22027.89
29-Mar-23,Karatoa,Vivabond (5Ltr.),1,15,1,16,2350,35250,189769.71
25-Mar-23,Karatoa,Clean 100ml,250,40,3,43,940,37600,55814.68
16-Mar-23,Karatoa,Vivabond (5Ltr.),1,1,0,1,2350,2350,15263.35
16-Mar-23,Karatoa,Clean 100ml,250,33,2,35,940,31020,49735.46
7-Mar-23,Karatoa,Clean 100ml,250,7,0,7,940,6580,8930.8
7-Mar-23,Karatoa,Clean 100ml,250,200,24,224,940,188000,86310.27
28-Feb-23,Karatoa,Clean 100ml,250,10,0,10,940,9400,21868.33
28-Feb-23,Karatoa,Clean 100ml,250,20,1,21,940,18800,22057.33
23-Feb-23,Karatoa,Clean 100ml,250,40,3,43,940,37600,84964.42
20-Feb-23,Karatoa,Clean 100ml,250,20,1,21,940,18800,33469.75
19-Feb-23,Karatoa,Clean 100ml,250,20,1,21,940,18800,17881.74
19-Feb-23,Karatoa,Clean 100ml,250,5,0,5,940,4700,12227.28
13-Feb-23,Karatoa,Clean 100ml,250,40,3,43,940,37600,63464.01
9-Feb-23,Karatoa,Clean 100ml,250,3,0,3,940,2820,17685.16
5-Feb-23,Karatoa,Clean 100ml,250,1,0,1,940,940,55814.68
4-Feb-23,Karatoa,Clean 100ml,250,5,0,5,940,4700,7352.21
4-Feb-23,Karatoa,Clean 100ml,250,60,5,65,940,56400,26462.4
4-Feb-23,Karatoa,Clean 100ml,250,200,25,225,940,188000,51619.47
2-Feb-23,Karatoa,Clean 100ml,250,40,3,43,940,37600,96102
2-Feb-23,Karatoa,Clean 100ml,250,60,5,65,940,56400,29328.64
2-Feb-23,Karatoa,Clean 100ml,250,1,0,1,940,940,11705.27
2-Feb-23,Karatoa,Clean 100ml,250,35,2,37,940,32900,30606.65
31-Jan-23,Karatoa,Clean 100ml,250,8,0,8,940,7520,18964.46
28-Jan-23,Karatoa,Clean 100ml,250,40,3,43,940,37600,49735.46
25-Jan-23,Karatoa,Clean 100ml,250,20,1,21,940,18800,38968.5
24-Jan-23,Karatoa,Clean 100ml,250,40,3,43,940,37600,58072.88
12-Jan-23,Karatoa,Clean 100ml,250,60,5,65,940,56400,33469.75
10-Jan-23,Karatoa,Clean 100ml,250,20,1,21,940,18800,69762.42
10-Jan-23,Karatoa,Clean 100ml,250,20,1,21,940,18800,22394.18
9-Jan-23,Karatoa,Clean 100ml,250,40,3,43,940,37600,24223.58
9-Jan-23,Karatoa,Clean 100ml,250,20,1,21,940,18800,15263.35
5-Jan-23,Karatoa,Clean 100ml,250,60,6,66,940,56400,127263.04
4-Jan-23,Karatoa,Clean 100ml,250,20,1,21,940,18800,19445.98
4-Jan-23,Karatoa,Clean 100ml,250,40,3,43,940,37600,15175.97
3-Jan-23,Karatoa,Clean 100ml,250,20,1,21,940,18800,23893.45
29-Dec-22,Karatoa,Clean 100ml,250,20,1,21,940,18800,47072.89
27-Dec-22,Karatoa,Clean 100ml,250,25,0,25,940,23500,27348.38
27-Dec-22,Karatoa,Clean 100ml,250,200,25,225,940,188000,71021.51
27-Dec-22,Karatoa,Clean 100ml,250,100,11,111,940,94000,46446.29
27-Dec-22,Karatoa,Clean 100ml,250,5,0,5,940,4700,7352.21
27-Dec-22,Karatoa,Clean 100ml,250,20,1,21,940,18800,33469.75
27-Dec-22,Karatoa,Clean 100ml,250,8,0,8,940,7520,22027.89
25-Dec-22,Karatoa,Clean 100ml,250,100,12,112,940,94000,86310.27
21-Dec-22,Karatoa,Clean 100ml,250,20,1,21,940,18800,84964.42
21-Dec-22,Karatoa,Clean 100ml,250,20,1,21,940,18800,80970.66
19-Dec-22,Karatoa,Clean 100ml,250,20,1,21,940,18800,16158.2
12-Dec-22,Karatoa,Clean 100ml,250,50,5,55,940,47000,22057.33
11-Dec-22,Karatoa,Clean 100ml,250,50,4,54,940,47000,37355.52
11-Dec-22,Karatoa,Clean 100ml,250,100,11,111,940,94000,38185.82
11-Dec-22,Karatoa,Clean 100ml,250,100,10,110,940,94000,71021.51
11-Dec-22,Karatoa,Clean 100ml,250,50,4,54,940,47000,51619.47
21-Nov-22,Karatoa,Clean 100ml,250,100,10,110,940,94000,91434.24
21-Nov-22,Karatoa,Clean 100ml,250,5,0,5,940,4700,23893.45
21-Nov-22,Karatoa,Clean 100ml,250,40,3,43,940,37600,16223.31
19-Nov-22,Karatoa,Clean 100ml,250,2,0,2,940,1880,86310.27
19-Nov-22,Karatoa,Clean 100ml,250,145,18,163,940,136300,86310.27
19-Nov-22,Karatoa,Clean 100ml,250,5,0,5,940,4700,86310.27
15-Nov-22,Karatoa,Clean 100ml,250,100,12,112,940,94000,60295.99
15-Nov-22,Karatoa,Clean 100ml,250,9,0,9,940,8460,54261.78
15-Nov-22,Karatoa,Clean 100ml,250,91,10,101,940,85540,54261.78
14-Nov-22,Karatoa,Clean 100ml,250,20,1,21,940,18800,9716.16
13-Nov-22,Karatoa,Clean 100ml,250,5,0,5,940,4700,11131.02
2-Nov-22,Karatoa,Clean 100ml,250,98,0,98,940,92120,46446.29
2-Nov-22,Karatoa,Clean 100ml,250,2,10,12,940,1880,46446.29
1-Nov-22,Karatoa,Clean 100ml,250,20,1,21,940,18800,25213.04
31-Oct-22,Karatoa,Clean 100ml,250,20,1,21,940,18800,11131.02
30-Oct-22,Karatoa,Clean 100ml,250,50,3,53,940,47000,189769.71
20-Oct-22,Karatoa,Clean 100ml,250,2,0,2,940,1880,15175.97
16-Oct-22,Karatoa,Clean 100ml,250,20,1,21,940,18800,55814.68
12-Oct-22,Karatoa,Clean 100ml,250,2,0,2,940,1880,17685.16
12-Oct-22,Karatoa,Clean 100ml,250,1,0,1,940,940,17685.16
11-Oct-22,Karatoa,Clean 100ml,250,20,1,21,940,18800,63464.01
2-Oct-22,Karatoa,Clean 100ml,250,5,0,5,940,4700,63464.01
30-Sep-22,Karatoa,Clean 100ml,250,20,1,21,940,18800,33699.26
30-Sep-22,Karatoa,Clean 100ml,250,20,1,21,940,18800,71021.51
29-Sep-22,Karatoa,Clean 100ml,250,24,1,25,940,22560,49090.35
27-Sep-22,Karatoa,Clean 100ml,250,19,0,19,940,17860,127263.04
27-Sep-22,Karatoa,Clean 100ml,250,31,6,37,940,29140,127263.04
24-Sep-22,Karatoa,Clean 100ml,250,12,0,12,940,11280,46446.29
24-Sep-22,Karatoa,Clean 100ml,250,8,1,9,940,7520,46446.29
20-Sep-22,Karatoa,Clean 100ml,250,6,0,6,940,5640,9716.16
19-Sep-22,Karatoa,Clean 100ml,250,100,12,112,940,94000,149803.5
14-Sep-22,Karatoa,Clean 100ml,250,1,0,1,940,940,15175.97
14-Sep-22,Karatoa,Clean 100ml,250,20,1,21,940,18800,80970.66
14-Sep-22,Karatoa,Clean 100ml,250,20,1,21,940,18800,30606.65
10-Sep-22,Karatoa,Clean 100ml,250,1,0,1,940,940,14032.38
6-Sep-22,Karatoa,Clean 100ml,250,20,1,21,940,18800,21868.33
6-Sep-22,Karatoa,Clean 100ml,250,25,0,25,940,23500,27348.38
4-Sep-22,Karatoa,Clean 100ml,250,2,0,2,940,1880,8296.2
3-Sep-22,Karatoa,Clean 100ml,250,20,1,21,940,18800,31825.09
1-Sep-22,Karatoa,Clean 100ml,250,20,1,21,940,18800,33469.75
1-Sep-22,Karatoa,Clean 100ml,250,20,1,21,940,18800,71021.51
1-Sep-22,Karatoa,Clean 100ml,250,5,0,5,940,4700,7395.82
31-Aug-22,Karatoa,Clean 100ml,250,10,0,10,940,9400,47072.89
30-Aug-22,Karatoa,Clean 100ml,250,17,1,18,940,15980,55814.68
30-Aug-22,Karatoa,Clean 100ml,250,3,0,3,940,2820,55814.68
29-Aug-22,Karatoa,Clean 100ml,250,5,0,5,940,4700,63464.01
27-Aug-22,Karatoa,Clean 100ml,250,20,1,21,940,18800,16223.31
25-Aug-22,Karatoa,Clean 100ml,250,40,3,43,940,37600,15175.97
25-Aug-22,Karatoa,Clean 100ml,250,20,1,21,940,18800,23893.45
25-Aug-22,Karatoa,Clean 100ml,250,20,1,21,940,18800,26196.34
25-Aug-22,Karatoa,Clean 100ml,250,5,0,5,940,4700,37355.52
23-Aug-22,Karatoa,Clean 100ml,250,60,5,65,940,56400,91434.24
22-Aug-22,Karatoa,Clean 100ml,250,300,18,318,940,282000,189769.71
22-Aug-22,Karatoa,Clean 100ml,250,10,0,10,940,9400,15263.35
21-Aug-22,Karatoa,Clean 100ml,250,20,1,21,940,18800,46446.29
21-Aug-22,Karatoa,Clean 100ml,250,100,12,112,940,94000,51619.47
20-Aug-22,Karatoa,Clean 100ml,250,6,0,6,940,5640,25213.04
4-Aug-22,Karatoa,Clean 100ml,250,2,0,2,940,1880,7352.21
4-Aug-22,Karatoa,Clean 100ml,250,70,6,76,940,65800,38185.82
3-Aug-22,Karatoa,Clean 100ml,250,5,0,5,940,4700,29581.46
31-Jul-22,Karatoa,Clean 100ml,250,4,0,4,940,3760,14032.38
31-Jul-22,Karatoa,Clean 100ml,250,200,24,224,940,188000,86310.27
31-Jul-22,Karatoa,Clean 100ml,250,20,1,21,940,18800,33469.75
28-Jul-22,Karatoa,Clean 100ml,250,20,1,21,940,18800,33699.26
27-Jul-22,Karatoa,Clean 100ml,250,100,5,105,940,94000,189769.71
27-Jul-22,Karatoa,Clean 100ml,250,11,0,11,940,10340,22627.14
26-Jul-22,Karatoa,Clean 100ml,250,1,0,1,940,940,14032.38
26-Jul-22,Karatoa,Clean 100ml,250,20,1,21,940,18800,16223.31
19-Jul-22,Karatoa,Clean 100ml,250,20,1,21,940,18800,33469.75
30-Jun-22,Karatoa,Fresmin F 10kg,11,15,1,16,4595,68925,49735.46
30-Jun-22,Karatoa,Clean 100ml,250,50,4,54,940,47000,49735.46
30-Jun-22,Karatoa,Clean 100ml,250,20,1,21,940,18800,33469.75
30-Jun-22,Karatoa,Clean 100ml,250,8,0,8,940,7520,91434.24
30-Jun-22,Karatoa,Clean 100ml,250,7,0,7,940,6580,91434.24
30-Jun-22,Karatoa,Clean 100ml,250,50,5,55,940,47000,91434.24
25-Jun-22,Karatoa,Fresmin F 10kg,11,1,0,1,4595,4595,8296.2
22-Jun-22,Karatoa,Clean 100ml,250,100,12,112,940,94000,86310.27
6-Jun-22,Karatoa,Clean 100ml,1,2,0,2,940,1880,36433.14
31-May-22,Karatoa,Clean 100ml,250,20,1,21,940,18800,33699.26
31-May-22,Karatoa,Clean 100ml,250,60,5,65,940,56400,91434.24
22-May-22,Karatoa,Clean 100ml,1,10,0,10,940,9400,7542.63
22-May-22,Karatoa,Clean 100ml,250,20,1,21,940,18800,51619.47
9-May-22,Karatoa,Clean 100ml,1,5,0,5,940,4700,6807.15
29-Apr-22,Karatoa,Clean 100ml,250,8,0,8,940,7520,16223.31
29-Apr-22,Karatoa,Clean 100ml,1,12,1,13,940,11280,16223.31
27-Apr-22,Karatoa,Clean 100ml,1,100,12,112,940,94000,60295.99
25-Apr-22,Karatoa,Clean 100ml,1,20,1,21,940,18800,16158.2
24-Apr-22,Karatoa,Clean 100ml,1,20,1,21,940,18800,33699.26
24-Apr-22,Karatoa,Clean 100ml,1,20,1,21,940,18800,51619.47
23-Apr-22,Karatoa,Clean 100ml,1,60,5,65,940,56400,58072.88
23-Apr-22,Karatoa,Clean 100ml,1,4,0,4,940,3760,9716.16
23-Apr-22,Karatoa,Clean 100ml,1,60,5,65,940,56400,54261.78
23-Apr-22,Karatoa,Clean 100ml,1,100,12,112,940,94000,86310.27
23-Apr-22,Karatoa,Clean 100ml,1,50,2,52,940,47000,189769.71
23-Apr-22,Karatoa,Clean 100ml,1,60,5,65,940,56400,91434.24
23-Apr-22,Karatoa,Clean 100ml,1,20,1,21,940,18800,33469.75
3-Oct-23,Karnaphuli,Clean 100ml,250,20,1,21,940,18800,16191.58
7-Sep-23,Karnaphuli,Clean 100ml,250,5,0,5,940,4700,7256.29
21-Aug-23,Karnaphuli,Clean 100ml,250,20,1,21,940,18800,8284.78
6-Aug-23,Karnaphuli,Clean 100ml,250,20,0,20,940,18800,133192.75
6-Aug-23,Karnaphuli,Clean 100ml,250,20,3,23,940,18800,133192.75
6-Aug-23,Karnaphuli,Clean 100ml,250,5,0,5,940,4700,5796.36
22-Jul-23,Karnaphuli,Clean 100ml,250,2,0,2,940,1880,8284.78
19-Jul-23,Karnaphuli,Clean 100ml,250,4,0,4,940,3760,5796.36
20-May-23,Karnaphuli,Clean 100ml,250,50,0,50,940,47000,26001.65
2-May-23,Karnaphuli,Clean 100ml,250,4,0,4,940,3760,6235.38
2-May-23,Karnaphuli,Clean 100ml,250,6,0,6,940,5640,6235.38
1-Apr-23,Karnaphuli,Clean 100ml,250,8,0,8,940,7520,35030.15
1-Apr-23,Karnaphuli,Clean 100ml,250,12,1,13,940,11280,35030.15
7-Mar-23,Karnaphuli,Clean 100ml,250,20,1,21,940,18800,98685.77
23-Feb-23,Karnaphuli,Clean 100ml,250,32,0,32,940,30080,51318.07
8-Feb-23,Karnaphuli,Clean 100ml,250,3,0,3,940,2820,14140.34
5-Feb-23,Karnaphuli,Clean 100ml,250,3,0,3,940,2820,5298.96
1-Feb-23,Karnaphuli,Clean 100ml,250,20,1,21,940,18800,13764.63
30-Jan-23,Karnaphuli,Clean 100ml,250,20,1,21,940,18800,35030.15
20-Jan-23,Karnaphuli,Clean 100ml,250,20,1,21,940,18800,133192.75
8-Jan-23,Karnaphuli,Clean 100ml,250,10,0,10,940,9400,5007.67
31-Dec-22,Karnaphuli,Clean 100ml,250,8,0,8,940,7520,7256.29
30-Dec-22,Karnaphuli,Clean 100ml,250,7,0,7,940,6580,20133.43
30-Dec-22,Karnaphuli,Clean 100ml,250,3,0,3,940,2820,20133.43
30-Dec-22,Karnaphuli,Clean 100ml,250,15,1,16,940,14100,20133.43
30-Dec-22,Karnaphuli,Clean 100ml,250,25,1,26,940,23500,12587.6
26-Dec-22,Karnaphuli,Clean 100ml,250,20,1,21,940,18800,133192.75
23-Dec-22,Karnaphuli,Clean 100ml,250,40,3,43,940,37600,7256.29
6-Oct-22,Karnaphuli,Clean 100ml,250,3,0,3,940,2820,12587.6
25-Sep-22,Karnaphuli,Clean 100ml,250,2,0,2,940,1880,6347.43
18-Sep-22,Karnaphuli,Clean 100ml,250,47,3,50,940,44180,20587.63
18-Sep-22,Karnaphuli,Clean 100ml,250,15,0,15,940,14100,6118.34
1-Sep-22,Karnaphuli,Clean 100ml,250,24,1,25,940,22560,21729.58
1-Sep-22,Karnaphuli,Clean 100ml,250,3,0,3,940,2820,9028.33
30-Aug-22,Karnaphuli,Clean 100ml,250,3,0,3,940,2820,5857.03
30-Aug-22,Karnaphuli,Clean 100ml,250,9,0,9,940,8460,5857.03
24-Aug-22,Karnaphuli,Clean 100ml,250,10,0,10,940,9400,10777.31
17-Aug-22,Karnaphuli,Clean 100ml,250,4,0,4,940,3760,6118.34
15-Aug-22,Karnaphuli,Clean 100ml,250,3,0,3,940,2820,10777.31
8-Aug-22,Karnaphuli,Clean 100ml,1,1,0,1,940,940,6118.34
8-Aug-22,Karnaphuli,Clean 100ml,250,2,0,2,940,1880,6118.34
4-Aug-22,Karnaphuli,Clean 100ml,250,20,0,20,940,18800,26001.65
28-Jul-22,Karnaphuli,Clean 100ml,250,5,0,5,940,4700,5857.03
27-Jul-22,Karnaphuli,Clean 100ml,250,10,0,10,940,9400,10777.31
28-Jun-22,Karnaphuli,Clean 100ml,1,7,0,7,940,6580,98685.77
22-Jun-22,Karnaphuli,Clean 100ml,1,5,0,5,940,4700,18836.85
11-May-22,Karnaphuli,Clean 100ml,1,8,0,8,940,7520,12587.6
27-Apr-22,Karnaphuli,Salivet 500ml,1,4,0,4,820,3280,5905.38
27-Apr-22,Karnaphuli,Salivet 1ltr,1,1,0,1,1575,1575,5905.38
23-Apr-22,Karnaphuli,Clean 100ml,1,40,3,43,940,37600,20568.01
23-Mar-22,Karnaphuli,Viusid Vet 500ml,5,4,0,4,2260,9040,5905.38
10-Nov-22,Kirtonkhola,Clean 100ml,250,2,0,2,940,1880,4161.62
6-Nov-22,Kirtonkhola,Clean 100ml,250,1,0,1,940,940,16994.34
6-Nov-22,Kirtonkhola,Clean 100ml,250,1,0,1,940,940,16994.34
6-Nov-22,Kirtonkhola,Clean 100ml,250,8,0,8,940,7520,16994.34
4-Oct-22,Kirtonkhola,Clean 100ml,250,5,0,5,940,4700,16994.34
28-Sep-22,Kirtonkhola,Clean 100ml,250,80,10,90,940,75200,131917.13
28-Sep-22,Kirtonkhola,Clean 100ml,250,16,0,16,940,15040,131917.13
28-Sep-22,Kirtonkhola,Clean 100ml,250,4,0,4,940,3760,131917.13
25-Sep-22,Kirtonkhola,Clean 100ml,250,3,0,3,940,2820,13585.72
19-Sep-22,Kirtonkhola,Clean 100ml,250,50,0,50,940,47000,131917.13
19-Sep-22,Kirtonkhola,Clean 100ml,250,50,10,60,940,47000,131917.13
7-Sep-22,Kirtonkhola,Clean 100ml,250,2,0,2,940,1880,10776.87
1-Sep-22,Kirtonkhola,Clean 100ml,250,10,0,10,940,9400,16994.34
25-Aug-22,Kirtonkhola,Clean 100ml,250,100,12,112,940,94000,99070.01
25-Aug-22,Kirtonkhola,Clean 100ml,250,20,1,21,940,18800,7793.97
24-Aug-22,Kirtonkhola,Clean 100ml,250,20,1,21,940,18800,20421.83
24-Aug-22,Kirtonkhola,Clean 100ml,250,20,1,21,940,18800,23429.16
20-Aug-22,Kirtonkhola,Clean 100ml,250,5,0,5,940,4700,13585.72
10-Aug-22,Kirtonkhola,Clean 100ml,250,10,0,10,940,9400,20522.84
7-Aug-22,Kirtonkhola,Clean 100ml,250,4,0,4,940,3760,20125.6
6-Aug-22,Kirtonkhola,Clean 100ml,250,2,0,2,940,1880,1560.4
4-Aug-22,Kirtonkhola,Clean 100ml,250,1,0,1,940,940,8009.55
27-Jul-22,Kirtonkhola,Clean 100ml,250,100,11,111,940,94000,99070.01
28-Jul-22,Kirtonkhola,Clean 100ml,250,4,0,4,940,3760,6423.31
27-Jul-22,Kirtonkhola,Clean 100ml,250,2,0,2,940,1880,15159.59
16-Jul-22,Kirtonkhola,Clean 100ml,1,5,0,5,940,4700,16994.34
21-Jun-22,Kirtonkhola,Clean 100ml,1,5,0,5,940,4700,18621.89
21-Jun-22,Kirtonkhola,Clean 100ml,1,4,0,4,940,3760,10776.87
9-Jun-22,Kirtonkhola,Clean 100ml,1,1,0,1,940,940,1628.77
5-Jun-22,Kirtonkhola,Clean 100ml,1,5,0,5,940,4700,20125.6
5-Jun-22,Kirtonkhola,Clean 100ml,1,6,0,6,940,5640,4204.03
25-May-22,Kirtonkhola,Clean 100ml,250,5,0,5,940,4700,20421.83
26-Apr-22,Kirtonkhola,Clean 100ml,1,2,0,2,940,1880,4204.03
26-Apr-22,Kirtonkhola,Clean 100ml,1,5,0,5,940,4700,20421.83
26-Apr-22,Kirtonkhola,Clean 100ml,1,10,0,10,940,9400,23429.16
25-Apr-22,Kirtonkhola,Clean 100ml,1,10,0,10,940,9400,3457.99
25-Apr-22,Kirtonkhola,Clean 100ml,1,100,12,112,940,94000,99070.01
24-Apr-22,Kirtonkhola,Clean 100ml,1,6,0,6,940,5640,16176.43
25-Oct-23,Kopotakkho,Clean 100ml,250,25,1,26,940,23500,34717.87
21-Oct-23,Kopotakkho,Clean 100ml,250,50,5,55,940,47000,209444.32
18-Oct-23,Kopotakkho,Clean 100ml,250,10,0,10,940,9400,26968.11
17-Oct-23,Kopotakkho,Clean 100ml,250,25,1,26,940,23500,32333.62
15-Oct-23,Kopotakkho,Clean 100ml,250,25,1,26,940,23500,54260.33
15-Oct-23,Kopotakkho,Clean 100ml,250,25,1,26,940,23500,104837.33
15-Oct-23,Kopotakkho,Clean 100ml,250,70,7,77,940,65800,209444.32
15-Oct-23,Kopotakkho,Clean 100ml,250,50,3,53,940,47000,63379.43
15-Oct-23,Kopotakkho,Clean 100ml,250,38,2,40,940,35720,64766.48
15-Oct-23,Kopotakkho,Clean 100ml,250,38,2,40,940,35720,47122.44
9-Oct-23,Kopotakkho,Clean 100ml,250,50,1,51,940,47000,63589.55
9-Oct-23,Kopotakkho,Clean 100ml,250,0,2,2,940,0,63589.55
9-Oct-23,Kopotakkho,Clean 100ml,250,50,3,53,940,47000,40511.69
7-Oct-23,Kopotakkho,Clean 100ml,250,30,2,32,940,28200,64766.48
6-Oct-23,Kopotakkho,Clean 100ml,250,6,0,6,940,5640,19601.06
1-Oct-23,Kopotakkho,Clean 100ml,250,1,0,1,940,940,86322.56
1-Oct-23,Kopotakkho,Clean 100ml,250,1,0,1,940,940,86322.56
1-Oct-23,Kopotakkho,Clean 100ml,250,4,0,4,940,3760,86322.56
1-Oct-23,Kopotakkho,Clean 100ml,250,1,0,1,940,940,86322.56
1-Oct-23,Kopotakkho,Clean 100ml,250,92,0,92,940,86480,86322.56
1-Oct-23,Kopotakkho,Clean 100ml,250,1,10,11,940,940,86322.56
21-Sep-23,Kopotakkho,Clean 100ml,250,20,1,21,940,18800,47122.44
16-Sep-23,Kopotakkho,Clean 100ml,250,100,8,108,940,94000,81630.6
13-Sep-23,Kopotakkho,Clean 100ml,250,100,10,110,940,94000,149406.3
7-Sep-23,Kopotakkho,Clean 100ml,250,150,15,165,940,141000,209444.32
4-Sep-23,Kopotakkho,Clean 100ml,250,2,0,2,940,1880,42776.01
2-Sep-23,Kopotakkho,Clean 100ml,250,10,0,10,940,9400,64766.48
2-Sep-23,Kopotakkho,Clean 100ml,250,2,0,2,940,1880,64766.48
2-Sep-23,Kopotakkho,Clean 100ml,250,25,1,26,940,23500,31817.99
29-Aug-23,Kopotakkho,Clean 100ml,250,60,4,64,940,56400,54260.33
29-Aug-23,Kopotakkho,Clean 100ml,250,25,1,26,940,23500,63379.43
24-Aug-23,Kopotakkho,Clean 100ml,250,100,10,110,940,94000,209444.32
24-Aug-23,Kopotakkho,Clean 100ml,250,20,1,21,940,18800,34717.87
22-Aug-23,Kopotakkho,Gentech - P.S (20 LTr.),0,1,0,1,11700,11700,20876.99
22-Aug-23,Kopotakkho,Clean 100ml,250,5,0,5,940,4700,19601.06
22-Aug-23,Kopotakkho,Clean 100ml,250,20,1,21,940,18800,61539.09
16-Aug-23,Kopotakkho,Clean 100ml,250,10,0,10,940,9400,8366
16-Aug-23,Kopotakkho,Clean 100ml,250,50,5,55,940,47000,209444.32
14-Aug-23,Kopotakkho,Clean 100ml,250,20,1,21,940,18800,61539.09
10-Aug-23,Kopotakkho,Clean 100ml,250,50,3,53,940,47000,86322.56
8-Aug-23,Kopotakkho,Clean 100ml,250,50,3,53,940,47000,40511.69
7-Aug-23,Kopotakkho,Clean 100ml,250,50,3,53,940,47000,63589.55
5-Aug-23,Kopotakkho,Clean 100ml,250,20,1,21,940,18800,61539.09
3-Aug-23,Kopotakkho,Clean 100ml,250,79,0,79,940,74260,81630.6
3-Aug-23,Kopotakkho,Clean 100ml,250,12,0,12,940,11280,81630.6
3-Aug-23,Kopotakkho,Clean 100ml,250,9,8,17,940,8460,81630.6
2-Aug-23,Kopotakkho,Clean 100ml,250,3,0,3,940,2820,10517.96
2-Aug-23,Kopotakkho,Clean 100ml,250,20,1,21,940,18800,32333.62
31-Jul-23,Kopotakkho,Clean 100ml,250,81,0,81,940,76140,209444.32
31-Jul-23,Kopotakkho,Clean 100ml,250,19,10,29,940,17860,209444.32
27-Jul-23,Kopotakkho,Clean 100ml,250,100,9,109,940,94000,104837.33
24-Jul-23,Kopotakkho,Clean 100ml,250,20,1,21,940,18800,40511.69
17-Jul-23,Kopotakkho,Clean 100ml,250,5,0,5,940,4700,19601.06
15-Jul-23,Kopotakkho,Clean 100ml,250,20,1,21,940,18800,61539.09
12-Jul-23,Kopotakkho,Clean 100ml,250,100,10,110,940,94000,209444.32
6-Jul-23,Kopotakkho,Clean 100ml,250,10,0,10,940,9400,8366
5-Jul-23,Kopotakkho,Clean 100ml,250,20,1,21,940,18800,32333.62
22-Jun-23,Kopotakkho,Clean 100ml,250,50,4,54,940,47000,63589.55
17-Jun-23,Kopotakkho,Clean 100ml,250,100,10,110,940,94000,209444.32
15-Jun-23,Kopotakkho,Clean 100ml,250,1,0,1,940,940,32333.62
9-Jun-23,Kopotakkho,Clean 100ml,250,12,0,12,940,11280,34717.87
6-Jun-23,Kopotakkho,Clean 100ml,250,50,4,54,940,47000,63379.43
5-Jun-23,Kopotakkho,Clean 100ml,250,25,1,26,940,23500,22005.07
5-Jun-23,Kopotakkho,Clean 100ml,250,25,1,26,940,23500,31817.99
4-Jun-23,Kopotakkho,Clean 100ml,250,20,1,21,940,18800,61539.09
28-May-23,Kopotakkho,Clean 100ml,250,100,10,110,940,94000,209444.32
14-May-23,Kopotakkho,Clean 100ml,250,50,4,54,940,47000,22027.26
10-May-23,Kopotakkho,Clean 100ml,250,5,1,6,940,4700,82114.27
10-May-23,Kopotakkho,Clean 100ml,250,15,0,15,940,14100,82114.27
10-May-23,Kopotakkho,Clean 100ml,250,50,5,55,940,47000,209444.32
10-May-23,Kopotakkho,Clean 100ml,250,20,1,21,940,18800,61539.09
6-May-23,Kopotakkho,Clean 100ml,250,2,0,2,940,1880,19601.06
6-May-23,Kopotakkho,Clean 100ml,250,100,12,112,940,94000,149406.3
6-May-23,Kopotakkho,Clean 100ml,250,100,10,110,940,94000,81630.6
2-May-23,Kopotakkho,Clean 100ml,250,50,5,55,940,47000,209444.32
25-Apr-23,Kopotakkho,Clean 100ml,250,10,0,10,940,9400,34717.87
25-Apr-23,Kopotakkho,Clean 100ml,250,50,4,54,940,47000,47122.44
25-Apr-23,Kopotakkho,Clean 100ml,250,50,4,54,940,47000,86322.56
20-Apr-23,Kopotakkho,Clean 100ml,250,10,0,10,940,9400,32333.62
17-Apr-23,Kopotakkho,Clean 100ml,250,50,4,54,940,47000,41490.5
8-Apr-23,Kopotakkho,Clean 100ml,250,20,1,21,940,18800,31817.99
6-Apr-23,Kopotakkho,Clean 100ml,250,60,5,65,940,56400,104837.33
2-Apr-23,Kopotakkho,Clean 100ml,250,50,3,53,940,47000,37658.09
1-Apr-23,Kopotakkho,Clean 100ml,250,60,5,65,940,56400,40511.69
27-Mar-23,Kopotakkho,Clean 100ml,250,3,0,3,940,2820,13403.7
27-Mar-23,Kopotakkho,Clean 100ml,250,10,0,10,940,9400,34717.87
26-Mar-23,Kopotakkho,Clean 100ml,250,2,0,2,940,1880,19601.06
23-Mar-23,Kopotakkho,Clean 100ml,250,10,0,10,940,9400,5218.18
23-Mar-23,Kopotakkho,Clean 100ml,250,20,1,21,940,18800,36718.06
18-Mar-23,Kopotakkho,Clean 100ml,250,20,1,21,940,18800,64766.48
15-Mar-23,Kopotakkho,Clean 100ml,250,50,3,53,940,47000,63379.43
14-Mar-23,Kopotakkho,Clean 100ml,250,4,0,4,940,3760,19601.06
13-Mar-23,Kopotakkho,Clean 100ml,250,30,3,33,940,28200,209444.32
11-Mar-23,Kopotakkho,Clean 100ml,250,3,0,3,940,2820,26968.11
7-Mar-23,Kopotakkho,Clean 100ml,250,20,1,21,940,18800,13715
6-Mar-23,Kopotakkho,Clean 100ml,250,20,1,21,940,18800,43343
4-Mar-23,Kopotakkho,Clean 100ml,250,20,1,21,940,18800,31817.99
25-Feb-23,Kopotakkho,Clean 100ml,250,25,1,26,940,23500,47122.44
22-Feb-23,Kopotakkho,Clean 100ml,250,8,0,8,940,7520,26968.11
19-Feb-23,Kopotakkho,Clean 100ml,250,50,3,53,940,47000,31581.5
18-Feb-23,Kopotakkho,Clean 100ml,250,2,0,2,940,1880,19601.06
13-Feb-23,Kopotakkho,Clean 100ml,250,20,1,21,940,18800,18021.91
11-Feb-23,Kopotakkho,Clean 100ml,250,10,0,10,940,9400,82114.27
8-Feb-23,Kopotakkho,Clean 100ml,250,20,1,21,940,18800,31817.99
7-Feb-23,Kopotakkho,Clean 100ml,250,20,1,21,940,18800,61539.09
5-Feb-23,Kopotakkho,Clean 100ml,250,20,1,21,940,18800,14575.76
4-Feb-23,Kopotakkho,Clean 100ml,250,25,1,26,940,23500,32333.62
23-Jan-23,Kopotakkho,Clean 100ml,250,25,1,26,940,23500,19096.57
23-Jan-23,Kopotakkho,Clean 100ml,250,60,5,65,940,56400,31581.5
21-Jan-23,Kopotakkho,Clean 100ml,250,10,0,10,940,9400,16628.46
19-Jan-23,Kopotakkho,Clean 100ml,250,20,0,20,940,18800,63379.43
19-Jan-23,Kopotakkho,Clean 100ml,250,0,1,1,940,0,63379.43
12-Jan-23,Kopotakkho,Clean 100ml,250,20,1,21,940,18800,61539.09
9-Jan-23,Kopotakkho,Clean 100ml,250,6,0,6,940,5640,38741.7
9-Jan-23,Kopotakkho,Clean 100ml,250,10,0,10,940,9400,31817.99
5-Jan-23,Kopotakkho,Clean 100ml,250,25,1,26,940,23500,22284.96
5-Jan-23,Kopotakkho,Clean 100ml,250,10,0,10,940,9400,34717.87
3-Jan-23,Kopotakkho,Clean 100ml,250,81,8,89,940,76140,81630.6
3-Jan-23,Kopotakkho,Clean 100ml,250,19,0,19,940,17860,81630.6
1-Jan-23,Kopotakkho,Clean 100ml,250,10,0,10,940,9400,42776.01
1-Jan-23,Kopotakkho,Clean 100ml,250,20,0,20,940,18800,104837.33
1-Jan-23,Kopotakkho,Clean 100ml,250,0,1,1,940,0,104837.33
28-Dec-22,Kopotakkho,Clean 100ml,250,13,0,13,940,12220,37658.09
28-Dec-22,Kopotakkho,Clean 100ml,250,10,0,10,940,9400,81630.6
27-Dec-22,Kopotakkho,Clean 100ml,250,100,12,112,940,94000,149406.3
26-Dec-22,Kopotakkho,Clean 100ml,250,100,11,111,940,94000,63589.55
22-Dec-22,Kopotakkho,Clean 100ml,250,20,1,21,940,18800,22027.26
18-Dec-22,Kopotakkho,Clean 100ml,250,20,1,21,940,18800,19096.57
13-Dec-22,Kopotakkho,Clean 100ml,250,25,1,26,940,23500,64766.48
13-Dec-22,Kopotakkho,Clean 100ml,250,10,0,10,940,9400,34717.87
13-Dec-22,Kopotakkho,Clean 100ml,250,100,10,110,940,94000,209444.32
13-Dec-22,Kopotakkho,Clean 100ml,250,50,4,54,940,47000,40511.69
19-Oct-22,Kopotakkho,Fresmin F 10kg,2178,40,4,44,4595,183800,209444.32
19-Oct-22,Kopotakkho,Fresmin F 10kg,2178,1,0,1,4595,4595,51853.02
15-Oct-22,Kopotakkho,Fresmin F 10kg,2178,12,1,13,4595,55140,27723.18
3-Oct-22,Kopotakkho,Clean 100ml,250,35,2,37,940,32900,81630.6
2-Oct-22,Kopotakkho,Clean 100ml,250,6,0,6,940,5640,13403.7
29-Sep-22,Kopotakkho,Clean 100ml,250,10,0,10,940,9400,29748.25
29-Sep-22,Kopotakkho,Clean 100ml,250,10,0,10,940,9400,18021.91
22-Sep-22,Kopotakkho,Clean 100ml,250,1,0,1,940,940,29085.17
21-Sep-22,Kopotakkho,Clean 100ml,250,25,1,26,940,23500,36295.78
20-Sep-22,Kopotakkho,Clean 100ml,250,50,3,53,940,47000,63379.43
17-Sep-22,Kopotakkho,Clean 100ml,250,50,3,53,940,47000,86322.56
8-Sep-22,Kopotakkho,Clean 100ml,250,5,0,5,940,4700,41490.5
8-Sep-22,Kopotakkho,Clean 100ml,250,25,1,26,940,23500,31817.99
7-Sep-22,Kopotakkho,Clean 100ml,250,1,0,1,940,940,29085.17
7-Sep-22,Kopotakkho,Clean 100ml,250,10,0,10,940,9400,22027.26
4-Sep-22,Kopotakkho,Clean 100ml,250,25,1,26,940,23500,149406.3
3-Sep-22,Kopotakkho,Clean 100ml,250,20,1,21,940,18800,64766.48
3-Sep-22,Kopotakkho,Clean 100ml,250,40,3,43,940,37600,47122.44
1-Sep-22,Kopotakkho,Clean 100ml,250,200,28,228,940,188000,209444.32
23-Aug-22,Kopotakkho,Clean 100ml,250,60,5,65,940,56400,81630.6
23-Aug-22,Kopotakkho,Clean 100ml,250,10,0,10,940,9400,22027.26
21-Aug-22,Kopotakkho,Clean 100ml,250,25,1,26,940,23500,51853.02
20-Aug-22,Kopotakkho,Clean 100ml,250,25,1,26,940,23500,23529.06
19-Aug-22,Kopotakkho,Clean 100ml,250,25,1,26,940,23500,32333.62
17-Aug-22,Kopotakkho,Clean 100ml,250,4,0,4,940,3760,29085.17
17-Aug-22,Kopotakkho,Clean 100ml,250,4,0,4,940,3760,32333.62
16-Aug-22,Kopotakkho,Fresmin F 10kg,11,10,1,11,4595,45950,82114.27
10-Aug-22,Kopotakkho,Clean 100ml,250,10,0,10,940,9400,18021.91
10-Aug-22,Kopotakkho,Clean 100ml,250,50,3,53,940,47000,86322.56
10-Aug-22,Kopotakkho,Clean 100ml,250,20,1,21,940,18800,149406.3
5-Aug-22,Kopotakkho,Clean 100ml,250,50,4,54,940,47000,63589.55
3-Aug-22,Kopotakkho,Clean 100ml,250,25,1,26,940,23500,32333.62
2-Aug-22,Kopotakkho,Clean 100ml,250,25,1,26,940,23500,31817.99
2-Aug-22,Kopotakkho,Clean 100ml,250,25,1,26,940,23500,22005.07
2-Aug-22,Kopotakkho,Clean 100ml,250,100,10,110,940,94000,209444.32
2-Aug-22,Kopotakkho,Clean 100ml,250,50,3,53,940,47000,63379.43
30-Jul-22,Kopotakkho,Clean 100ml,250,20,1,21,940,18800,19096.57
28-Jul-22,Kopotakkho,Clean 100ml,250,40,1,41,940,37600,36295.78
28-Jul-22,Kopotakkho,Clean 100ml,250,0,2,2,940,0,36295.78
26-Jul-22,Kopotakkho,Fresmin F 10kg,11,1,0,1,4595,4595,27723.18
26-Jul-22,Kopotakkho,Clean 100ml,250,10,0,10,940,9400,81630.6
26-Jul-22,Kopotakkho,Clean 100ml,250,1,0,1,940,940,209444.32
26-Jul-22,Kopotakkho,Clean 100ml,250,9,0,9,940,8460,209444.32
26-Jul-22,Kopotakkho,Clean 100ml,250,63,0,63,940,59220,209444.32
26-Jul-22,Kopotakkho,Clean 100ml,250,27,10,37,940,25380,209444.32
26-Jul-22,Kopotakkho,Clean 100ml,250,25,1,26,940,23500,63379.43
26-Jul-22,Kopotakkho,Clean 100ml,250,20,1,21,940,18800,64766.48
26-Jul-22,Kopotakkho,Clean 100ml,250,10,0,10,940,9400,41490.5
26-Jul-22,Kopotakkho,Clean 100ml,250,100,11,111,940,94000,104837.33
16-Jul-22,Kopotakkho,Clean 100ml,250,38,0,38,940,35720,18021.91
16-Jul-22,Kopotakkho,Clean 100ml,250,12,3,15,940,11280,18021.91
6-Jul-22,Kopotakkho,Clean 100ml,250,5,0,5,940,4700,7528.33
6-Jul-22,Kopotakkho,Clean 100ml,250,25,1,26,940,23500,64766.48
6-Jul-22,Kopotakkho,Clean 100ml,250,25,1,26,940,23500,34717.87
4-Jul-22,Kopotakkho,Clean 100ml,250,20,1,21,940,18800,36295.78
4-Jul-22,Kopotakkho,Clean 100ml,250,30,1,31,940,28200,86322.56
4-Jul-22,Kopotakkho,Clean 100ml,250,50,3,53,940,47000,47122.44
12-Jun-22,Kopotakkho,Clean 100ml,1,2,0,2,940,1880,36295.78
2-Jun-22,Kopotakkho,Clean 100ml,1,6,0,6,940,5640,31920.41
1-Jun-22,Kopotakkho,Clean 100ml,1,25,1,26,940,23500,63589.55
22-May-22,Kopotakkho,Clean 100ml,1,6,0,6,940,5640,36295.78
18-May-22,Kopotakkho,Clean 100ml,1,10,0,10,940,9400,63589.55
17-May-22,Kopotakkho,Clean 100ml,1,4,0,4,940,3760,9030.16
13-May-22,Kopotakkho,Clean 100ml,1,10,0,10,940,9400,22351.9
12-May-22,Kopotakkho,Clean 100ml,1,10,0,10,940,9400,34717.87
11-May-22,Kopotakkho,Clean 100ml,1,20,1,21,940,18800,31817.99
11-May-22,Kopotakkho,Clean 100ml,1,20,1,21,940,18800,37658.09
8-May-22,Kopotakkho,Clean 100ml,1,20,2,22,940,18800,209444.32
26-Apr-22,Kopotakkho,Clean 100ml,1,4,0,4,940,3760,42776.01
25-Apr-22,Kopotakkho,Clean 100ml,1,5,0,5,940,4700,34717.87
24-Apr-22,Kopotakkho,Clean 100ml,1,6,0,6,940,5640,9030.16
24-Apr-22,Kopotakkho,Clean 100ml,1,20,1,21,940,18800,19096.57
19-Oct-23,Muhuri,Clean 100ml,250,55,0,55,940,51700,92495.92
19-Oct-23,Muhuri,Clean 100ml,250,0,1,1,940,0,92495.92
19-Oct-23,Muhuri,Clean 100ml,250,0,2,2,940,0,92495.92
19-Oct-23,Muhuri,Clean 100ml,250,0,1,1,940,0,92495.92
19-Oct-23,Muhuri,Clean 100ml,250,100,10,110,940,94000,97905.52
19-Oct-23,Muhuri,Clean 100ml,250,120,13,133,940,112800,101704.75
19-Oct-23,Muhuri,Clean 100ml,250,20,1,21,940,18800,20212.02
19-Oct-23,Muhuri,Clean 100ml,250,50,4,54,940,47000,21036.63
27-Sep-23,Muhuri,Clean 100ml,250,15,0,15,940,14100,7183.65
27-Sep-23,Muhuri,Clean 100ml,250,25,0,25,940,23500,25831.49
27-Sep-23,Muhuri,Clean 100ml,250,0,1,1,940,0,25831.49
26-Sep-23,Muhuri,Clean 100ml,250,20,0,20,940,18800,30693.48
26-Sep-23,Muhuri,Clean 100ml,250,0,1,1,940,0,30693.48
25-Sep-23,Muhuri,Clean 100ml,250,76,0,76,940,71440,97905.52
25-Sep-23,Muhuri,Clean 100ml,250,9,11,20,940,8460,97905.52
25-Sep-23,Muhuri,Clean 100ml,250,15,0,15,940,14100,97905.52
24-Sep-23,Muhuri,Clean 100ml,250,100,0,100,940,94000,134591.3
24-Sep-23,Muhuri,Clean 100ml,250,0,5,5,940,0,134591.3
24-Sep-23,Muhuri,Clean 100ml,250,0,6,6,940,0,134591.3
23-Sep-23,Muhuri,Clean 100ml,250,20,1,21,940,18800,20587.63
21-Sep-23,Muhuri,Clean 100ml,250,100,11,111,940,94000,117526.3
19-Sep-23,Muhuri,Clean 100ml,250,20,1,21,940,18800,17882.65
10-Sep-23,Muhuri,Clean 100ml,250,20,1,21,940,18800,25374.59
7-Sep-23,Muhuri,Clean 100ml,250,20,1,21,940,18800,25831.49
7-Sep-23,Muhuri,Clean 100ml,250,20,1,21,940,18800,20212.02
5-Sep-23,Muhuri,Clean 100ml,250,200,0,200,940,188000,117526.3
5-Sep-23,Muhuri,Clean 100ml,250,0,25,25,940,0,117526.3
4-Sep-23,Muhuri,Clean 100ml,250,10,0,10,940,9400,25831.49
31-Aug-23,Muhuri,Clean 100ml,250,50,4,54,940,47000,104291.36
28-Aug-23,Muhuri,Clean 100ml,250,200,22,222,940,188000,134591.3
17-Aug-23,Muhuri,Clean 100ml,250,10,0,10,940,9400,30693.48
17-Aug-23,Muhuri,Clean 100ml,250,10,1,11,940,9400,30693.48
13-Aug-23,Muhuri,Clean 100ml,250,25,0,25,940,23500,25831.49
13-Aug-23,Muhuri,Clean 100ml,250,0,1,1,940,0,25831.49
10-Aug-23,Muhuri,Clean 100ml,250,20,0,20,940,18800,20587.63
10-Aug-23,Muhuri,Clean 100ml,250,0,1,1,940,0,20587.63
6-Aug-23,Muhuri,Clean 100ml,250,40,0,40,940,37600,30693.48
6-Aug-23,Muhuri,Clean 100ml,250,0,3,3,940,0,30693.48
6-Aug-23,Muhuri,Clean 100ml,250,100,0,100,940,94000,101704.75
6-Aug-23,Muhuri,Clean 100ml,250,0,11,11,940,0,101704.75
6-Aug-23,Muhuri,Clean 100ml,250,50,0,50,940,47000,104291.36
6-Aug-23,Muhuri,Clean 100ml,250,0,4,4,940,0,104291.36
30-Jul-23,Muhuri,Clean 100ml,250,8,0,8,940,7520,7183.65
22-Jul-23,Muhuri,Clean 100ml,250,100,10,110,940,94000,117526.3
22-Jul-23,Muhuri,Clean 100ml,250,47,0,47,940,44180,97905.52
22-Jul-23,Muhuri,Clean 100ml,250,53,10,63,940,49820,97905.52
18-Jul-23,Muhuri,Clean 100ml,250,20,1,21,940,18800,17882.65
11-Jul-23,Muhuri,Clean 100ml,250,20,0,20,940,18800,20587.63
11-Jul-23,Muhuri,Clean 100ml,250,0,1,1,940,0,20587.63
11-Jul-23,Muhuri,Clean 100ml,250,60,0,60,940,56400,104291.36
11-Jul-23,Muhuri,Clean 100ml,250,0,5,5,940,0,104291.36
11-Jul-23,Muhuri,Clean 100ml,250,20,1,21,940,18800,134591.3
9-Jul-23,Muhuri,Clean 100ml,250,120,0,120,940,112800,101704.75
9-Jul-23,Muhuri,Clean 100ml,250,0,13,13,940,0,101704.75
9-Jul-23,Muhuri,Clean 100ml,250,60,5,65,940,56400,60116.8
9-Jul-23,Muhuri,Clean 100ml,250,100,11,111,940,94000,97905.52
9-Jul-23,Muhuri,Clean 100ml,250,200,25,225,940,188000,119397.69
9-Jul-23,Muhuri,Clean 100ml,250,20,1,21,940,18800,21036.63
8-Jul-23,Muhuri,Clean 100ml,250,27,0,27,940,25380,79999.95
8-Jul-23,Muhuri,Clean 100ml,250,73,11,84,940,68620,79999.95
6-Jul-23,Muhuri,Clean 100ml,250,200,18,218,940,188000,117526.3
6-Jul-23,Muhuri,Clean 100ml,250,0,7,7,940,0,117526.3
22-Jun-23,Muhuri,Clean 100ml,250,7,0,7,940,6580,20568.01
15-Jun-23,Muhuri,Clean 100ml,250,20,1,21,940,18800,20587.63
25-May-23,Muhuri,Clean 100ml,250,20,1,21,940,18800,54102.02
21-May-23,Muhuri,Clean 100ml,250,25,1,26,940,23500,25831.49
18-May-23,Muhuri,Clean 100ml,250,20,1,21,940,18800,21036.63
9-May-23,Muhuri,Clean 100ml,250,20,1,21,940,18800,20587.63
8-May-23,Muhuri,Clean 100ml,250,10,0,10,940,9400,19157.75
7-May-23,Muhuri,Clean 100ml,250,20,0,20,940,18800,30693.48
7-May-23,Muhuri,Clean 100ml,250,0,1,1,940,0,30693.48
30-Apr-23,Muhuri,Clean 100ml,250,40,0,40,940,37600,92495.92
30-Apr-23,Muhuri,Clean 100ml,250,0,3,3,940,0,92495.92
30-Apr-23,Muhuri,Clean 100ml,250,50,0,50,940,47000,134591.3
30-Apr-23,Muhuri,Clean 100ml,250,0,3,3,940,0,134591.3
16-Apr-23,Muhuri,Clean 100ml,250,60,5,65,940,56400,60116.8
11-Apr-23,Muhuri,Clean 100ml,250,20,1,21,940,18800,25831.49
9-Apr-23,Muhuri,Clean 100ml,250,20,1,21,940,18800,30693.48
9-Apr-23,Muhuri,Clean 100ml,250,3,0,3,940,2820,9889.45
6-Apr-23,Muhuri,Clean 100ml,250,100,11,111,940,94000,117526.3
6-Apr-23,Muhuri,Clean 100ml,250,40,3,43,940,37600,92495.92
5-Apr-23,Muhuri,Clean 100ml,250,60,5,65,940,56400,101704.75
5-Apr-23,Muhuri,Clean 100ml,250,25,1,26,940,23500,20212.02
16-Mar-23,Muhuri,Clean 100ml,250,20,1,21,940,18800,20587.63
15-Mar-23,Muhuri,Clean 100ml,250,50,3,53,940,47000,134591.3
15-Mar-23,Muhuri,Clean 100ml,250,100,1,101,940,94000,97905.52
15-Mar-23,Muhuri,Clean 100ml,250,0,10,10,940,0,97905.52
14-Mar-23,Muhuri,Clean 100ml,250,50,4,54,940,47000,92495.92
13-Mar-23,Muhuri,Clean 100ml,250,15,0,15,940,14100,117526.3
13-Mar-23,Muhuri,Clean 100ml,250,85,10,95,940,79900,117526.3
23-Feb-23,Muhuri,Clean 100ml,250,60,5,65,940,56400,60116.8
19-Feb-23,Muhuri,Clean 100ml,250,5,0,5,940,4700,10777.31
18-Feb-23,Muhuri,Clean 100ml,250,25,1,26,940,23500,20212.02
8-Feb-23,Muhuri,Clean 100ml,250,20,1,21,940,18800,13320.91
7-Feb-23,Muhuri,Clean 100ml,250,100,10,110,940,94000,79999.95
6-Feb-23,Muhuri,Clean 100ml,250,37,0,37,940,34780,117526.3
6-Feb-23,Muhuri,Clean 100ml,250,3,3,6,940,2820,117526.3
6-Feb-23,Muhuri,Clean 100ml,250,20,1,21,940,18800,21036.63
31-Jan-23,Muhuri,Clean 100ml,250,10,0,10,940,9400,25831.49
31-Jan-23,Muhuri,Clean 100ml,250,100,10,110,940,94000,117526.3
29-Jan-23,Muhuri,Clean 100ml,250,20,1,21,940,18800,20587.63
26-Jan-23,Muhuri,Clean 100ml,250,10,0,10,940,9400,22901.1
25-Jan-23,Muhuri,Clean 100ml,250,60,5,65,940,56400,101704.75
25-Jan-23,Muhuri,Clean 100ml,250,100,10,110,940,94000,134591.3
23-Jan-23,Muhuri,Clean 100ml,250,3,0,3,940,2820,9889.45
18-Jan-23,Muhuri,Clean 100ml,250,5,0,5,940,4700,7183.65
9-Jan-23,Muhuri,Clean 100ml,250,60,5,65,940,56400,104291.36
9-Jan-23,Muhuri,Clean 100ml,250,60,5,65,940,56400,30851.52
8-Jan-23,Muhuri,Clean 100ml,250,100,10,110,940,94000,97905.52
4-Jan-23,Muhuri,Clean 100ml,250,20,1,21,940,18800,20568.01
31-Dec-22,Muhuri,Clean 100ml,250,100,11,111,940,94000,117526.3
31-Dec-22,Muhuri,Clean 100ml,250,60,5,65,940,56400,60116.8
31-Dec-22,Muhuri,Clean 100ml,250,0,1,1,940,0,21036.63
31-Dec-22,Muhuri,Clean 100ml,250,20,0,20,940,18800,21036.63
21-Dec-22,Muhuri,Clean 100ml,250,23,1,24,940,21620,19157.75
26-Dec-22,Muhuri,Clean 100ml,250,12,0,12,940,11280,21036.63
26-Dec-22,Muhuri,Clean 100ml,250,20,1,21,940,18800,17882.65
22-Dec-22,Muhuri,Clean 100ml,250,10,0,10,940,9400,13647.57
14-Dec-22,Muhuri,Clean 100ml,250,20,1,21,940,18800,16494.17
14-Dec-22,Muhuri,Clean 100ml,250,100,10,110,940,94000,119397.69
14-Dec-22,Muhuri,Clean 100ml,250,3,0,3,940,2820,9889.45
13-Dec-22,Muhuri,Clean 100ml,250,20,1,21,940,18800,20212.02
14-Nov-22,Muhuri,Clean 100ml,250,100,10,110,940,94000,86401.2
10-Nov-22,Muhuri,Clean 100ml,250,3,0,3,940,2820,13320.91
10-Nov-22,Muhuri,Clean 100ml,250,40,3,43,940,37600,28120.76
16-Oct-22,Muhuri,Clean 100ml,250,100,11,111,940,94000,92495.92
15-Oct-22,Muhuri,Clean 100ml,250,60,5,65,940,56400,54102.02
15-Oct-22,Muhuri,Clean 100ml,250,100,10,110,940,94000,104291.36
8-Oct-22,Muhuri,Clean 100ml,250,43,0,43,940,40420,104291.36
8-Oct-22,Muhuri,Clean 100ml,250,57,12,69,940,53580,104291.36
6-Oct-22,Muhuri,Clean 100ml,250,160,21,181,940,150400,97905.52
6-Oct-22,Muhuri,Clean 100ml,250,20,1,21,940,18800,33325.94
29-Sep-22,Muhuri,Clean 100ml,250,90,0,90,940,84600,117526.3
29-Sep-22,Muhuri,Clean 100ml,250,10,0,10,940,9400,117526.3
29-Sep-22,Muhuri,Clean 100ml,250,100,24,124,940,94000,117526.3
3-Sep-22,Muhuri,Clean 100ml,250,100,12,112,940,94000,148133.6
31-Aug-22,Muhuri,Clean 100ml,250,20,1,21,940,18800,20212.02
25-Aug-22,Muhuri,Clean 100ml,250,30,2,32,940,28200,30851.52
25-Aug-22,Muhuri,Clean 100ml,250,40,3,43,940,37600,45296.55
25-Aug-22,Muhuri,Clean 100ml,250,115,9,124,940,108100,92495.92
25-Aug-22,Muhuri,Clean 100ml,250,0,4,4,940,0,92495.92
25-Aug-22,Muhuri,Clean 100ml,250,0,1,1,940,0,92495.92
21-Aug-22,Muhuri,Clean 100ml,250,200,26,226,940,188000,117526.3
16-Aug-22,Muhuri,Clean 100ml,250,19,0,19,940,17860,86401.2
16-Aug-22,Muhuri,Clean 100ml,250,31,0,31,940,29140,86401.2
16-Aug-22,Muhuri,Clean 100ml,250,50,11,61,940,47000,86401.2
8-Aug-22,Muhuri,Clean 100ml,250,40,3,43,940,37600,30693.48
8-Aug-22,Muhuri,Clean 100ml,250,200,24,224,940,188000,119397.69
4-Aug-22,Muhuri,Clean 100ml,250,20,1,21,940,18800,20212.02
3-Aug-22,Muhuri,Clean 100ml,250,14,0,14,940,13160,104291.36
3-Aug-22,Muhuri,Clean 100ml,250,86,11,97,940,80840,104291.36
2-Aug-22,Muhuri,Clean 100ml,250,100,11,111,940,94000,97905.52
31-Jul-22,Muhuri,Clean 100ml,250,10,0,10,940,9400,33325.94
28-Jul-22,Muhuri,Clean 100ml,250,60,5,65,940,56400,60116.8
21-Jul-22,Muhuri,Fresmin F 10kg,11,10,1,11,4595,45950,134591.3
20-Jul-22,Muhuri,Clean 100ml,250,100,10,110,940,94000,104291.36
20-Jul-22,Muhuri,Viusid Vet 500ml,5,6,0,6,2260,13560,134591.3
29-Jun-22,Muhuri,Clean 100ml,250,100,10,110,940,94000,117526.3
31-May-22,Muhuri,Clean 100ml,250,20,1,21,940,18800,17882.65
31-May-22,Muhuri,Clean 100ml,250,20,1,21,940,18800,45296.55
31-May-22,Muhuri,Clean 100ml,250,10,0,10,940,9400,20212.02
31-May-22,Muhuri,Clean 100ml,250,50,4,54,940,47000,60116.8
31-May-22,Muhuri,Clean 100ml,250,60,5,65,940,56400,97905.52
28-May-22,Muhuri,Clean 100ml,250,31,0,31,940,29140,54102.02
28-May-22,Muhuri,Clean 100ml,250,16,0,16,940,15040,54102.02
28-May-22,Muhuri,Clean 100ml,1,3,3,6,940,2820,54102.02
22-May-22,Muhuri,Viusid Vet 500ml,5,20,2,22,2260,45200,37516
20-May-22,Muhuri,Clean 100ml,1,7,0,7,940,6580,30693.48
17-May-22,Muhuri,Clean 100ml,250,20,1,21,940,18800,30851.52
14-May-22,Muhuri,Clean 100ml,250,20,1,21,940,18800,15604
28-Apr-22,Muhuri,Clean 100ml,250,20,1,21,940,18800,30693.48
27-Apr-22,Muhuri,Clean 100ml,250,20,1,21,940,18800,134591.3
26-Apr-22,Muhuri,Clean 100ml,1,20,1,21,940,18800,13320.91
25-Apr-22,Muhuri,Clean 100ml,1,125,14,139,940,117500,79999.95
24-Apr-22,Muhuri,Clean 100ml,1,25,1,26,940,23500,45296.55
24-Apr-22,Muhuri,Clean 100ml,1,60,5,65,940,56400,60116.8
24-Apr-22,Muhuri,Clean 100ml,1,100,12,112,940,94000,86401.2
24-Apr-22,Muhuri,Clean 100ml,1,100,12,112,940,94000,92495.92
24-Apr-22,Muhuri,Clean 100ml,1,100,12,112,940,94000,119397.69
19-Oct-23,Padma,Clean 100ml,250,27,0,27,940,25380,24153.28
19-Oct-23,Padma,Clean 100ml,250,13,3,16,940,12220,24153.28
17-Oct-23,Padma,Clean 100ml,250,20,1,21,940,18800,22420.42
4-Oct-23,Padma,Clean 100ml,250,20,1,21,940,18800,27302
30-Sep-23,Padma,Clean 100ml,250,20,1,21,940,18800,24319
27-Sep-23,Padma,Clean 100ml,250,100,11,111,940,94000,90812.65
23-Sep-23,Padma,Gentech - P.S (20 LTr.),0,1,0,1,11700,11700,28621.51
19-Sep-23,Padma,Clean 100ml,250,100,11,111,940,94000,77816.65
18-Sep-23,Padma,Clean 100ml,250,60,5,65,940,56400,55448.86
17-Sep-23,Padma,Clean 100ml,250,100,12,112,940,94000,102001.3
14-Sep-23,Padma,Clean 100ml,250,100,11,111,940,94000,88811.05
9-Sep-23,Padma,Clean 100ml,250,100,11,111,940,94000,104696.05
9-Sep-23,Padma,Clean 100ml,250,6,0,6,940,5640,22420.42
9-Sep-23,Padma,Clean 100ml,250,5,0,5,940,4700,22420.42
9-Sep-23,Padma,Clean 100ml,250,9,1,10,940,8460,22420.42
5-Sep-23,Padma,Clean 100ml,250,30,2,32,940,28200,77816.65
26-Aug-23,Padma,Clean 100ml,250,20,0,20,940,18800,77816.65
26-Aug-23,Padma,Clean 100ml,250,0,1,1,940,0,77816.65
16-Aug-23,Padma,Clean 100ml,250,20,1,21,940,18800,23483.22
16-Aug-23,Padma,Clean 100ml,250,100,11,111,940,94000,26729.97
10-Aug-23,Padma,Clean 100ml,250,100,0,100,940,94000,75824.21
10-Aug-23,Padma,Clean 100ml,250,0,10,10,940,0,75824.21
6-Aug-23,Padma,Clean 100ml,250,20,1,21,940,18800,24153.28
5-Aug-23,Padma,Gentech - P.S (20 LTr.),0,10,1,11,11700,117000,70415.33
3-Aug-23,Padma,Clean 100ml,250,20,1,21,940,18800,23483.22
2-Aug-23,Padma,Clean 100ml,250,100,10,110,940,94000,43984.27
2-Aug-23,Padma,Clean 100ml,250,20,1,21,940,18800,16339.31
24-Jul-23,Padma,Clean 100ml,250,20,1,21,940,18800,32966.58
20-Jul-23,Padma,Clean 100ml,250,20,1,21,940,18800,55448.86
15-Jul-23,Padma,Clean 100ml,250,20,1,21,940,18800,22420.42
13-Jul-23,Padma,Clean 100ml,250,20,1,21,940,18800,15604
25-Sep-23,Padma,Clean 100ml,250,0,0,0,940,0,15604
13-Jul-23,Padma,Clean 100ml,250,100,11,111,940,94000,70415.33
13-Jul-23,Padma,Gentech - P.S (20 LTr.),0,2,0,2,11700,23400,70415.33
13-Jul-23,Padma,Gentech - P.S (20 LTr.),0,1,0,1,11700,11700,16017.86
11-Jul-23,Padma,Clean 100ml,250,60,5,65,940,56400,26729.97
11-Jul-23,Padma,Clean 100ml,250,60,5,65,940,56400,88811.05
10-Jul-23,Padma,Clean 100ml,250,6,0,6,940,5640,30225.39
9-Jul-23,Padma,Clean 100ml,250,10,0,10,940,9400,36155.34
27-Jun-23,Padma,Clean 100ml,250,50,5,55,940,47000,26586.07
25-Jun-23,Padma,Clean 100ml,250,60,5,65,940,56400,45766
24-Jun-23,Padma,Clean 100ml,250,20,0,20,940,18800,32966.58
24-Jun-23,Padma,Clean 100ml,250,0,1,1,940,0,32966.58
17-Jun-23,Padma,Clean 100ml,250,12,0,12,940,11280,32966.58
17-Jun-23,Padma,Clean 100ml,250,8,1,9,940,7520,32966.58
17-Jun-23,Padma,Gentech - P.S (20 LTr.),0,1,0,1,11700,11700,24156.23
15-Jun-23,Padma,Clean 100ml,250,20,1,21,940,18800,24153.28
14-Jun-23,Padma,Clean 100ml,250,100,12,112,940,94000,104696.05
8-Jun-23,Padma,Clean 100ml,250,20,1,21,940,18800,22420.42
3-Jun-23,Padma,Clean 100ml,250,6,0,6,940,5640,30225.39
1-Jun-23,Padma,Clean 100ml,250,20,1,21,940,18800,23483.22
14-May-23,Padma,Clean 100ml,250,20,1,21,940,18800,23483.22
10-May-23,Padma,Clean 100ml,250,100,11,111,940,94000,102001.3
7-May-23,Padma,Clean 100ml,250,20,1,21,940,18800,16533.4
6-May-23,Padma,Clean 100ml,250,2,0,2,940,1880,29602.23
6-May-23,Padma,Clean 100ml,250,4,0,4,940,3760,20269.46
29-Apr-23,Padma,Clean 100ml,250,20,1,21,940,18800,26729.97
17-Apr-23,Padma,Gentech - P.S (20 LTr.),0,1,0,1,11700,11700,24156.23
11-Apr-23,Padma,Clean 100ml,250,6,0,6,940,5640,30225.39
9-Apr-23,Padma,Clean 100ml,250,20,1,21,940,18800,32966.58
9-Apr-23,Padma,Clean 100ml,250,20,1,21,940,18800,24153.28
9-Apr-23,Padma,Clean 100ml,250,20,1,21,940,18800,16339.31
6-Apr-23,Padma,Vivamin (10kg),1,10,0,10,1830,18300,32707.5
27-Mar-23,Padma,Clean 100ml,250,20,1,21,940,18800,22420.42
20-Mar-23,Padma,Clean 100ml,250,15,1,16,940,14100,45550.13
16-Mar-23,Padma,Clean 100ml,250,100,10,110,940,94000,90812.65
15-Mar-23,Padma,Clean 100ml,250,15,1,16,940,14100,14655.28
14-Mar-23,Padma,Gentech - P.S (20 LTr.),0,1,0,1,11700,11700,46574.72
12-Mar-23,Padma,Clean 100ml,250,20,1,21,940,18800,22420.42
12-Mar-23,Padma,Clean 100ml,250,5,0,5,940,4700,16339.31
11-Mar-23,Padma,Clean 100ml,250,20,1,21,940,18800,23483.22
6-Mar-23,Padma,Clean 100ml,250,14,0,14,940,13160,24156.23
6-Mar-23,Padma,Clean 100ml,250,6,1,7,940,5640,24156.23
2-Mar-23,Padma,Clean 100ml,250,20,1,21,940,18800,88811.05
2-Mar-23,Padma,Clean 100ml,250,100,10,110,940,94000,50584.55
18-Feb-23,Padma,Clean 100ml,250,2,0,2,940,1880,15722.76
15-Feb-23,Padma,Clean 100ml,250,30,2,32,940,28200,55448.86
8-Feb-23,Padma,Clean 100ml,250,50,5,55,940,47000,24153.28
6-Feb-23,Padma,Clean 100ml,250,20,1,21,940,18800,16339.31
1-Feb-23,Padma,Clean 100ml,250,6,0,6,940,5640,16533.4
30-Jan-23,Padma,Clean 100ml,250,20,1,21,940,18800,39056.84
21-Jan-23,Padma,Clean 100ml,250,20,1,21,940,18800,32966.58
19-Jan-23,Padma,Gentech - P.S (20 LTr.),0,5,0,5,11700,58500,24380.2
17-Jan-23,Padma,Clean 100ml,250,30,2,32,940,28200,41880.48
17-Jan-23,Padma,Clean 100ml,250,100,11,111,940,94000,70415.33
15-Jan-23,Padma,Clean 100ml,250,100,11,111,940,94000,75824.21
14-Jan-23,Padma,Clean 100ml,250,60,5,65,940,56400,30161.12
14-Jan-23,Padma,Clean 100ml,250,100,11,111,940,94000,104696.05
12-Jan-23,Padma,Clean 100ml,250,15,1,16,940,14100,24380.2
12-Jan-23,Padma,Clean 100ml,250,100,10,110,940,94000,90812.65
11-Jan-23,Padma,Clean 100ml,250,20,1,21,940,18800,21958.67
8-Jan-23,Padma,Clean 100ml,250,20,1,21,940,18800,23483.22
8-Jan-23,Padma,Clean 100ml,250,20,1,21,940,18800,24153.28
2-Jan-23,Padma,Clean 100ml,250,20,1,21,940,18800,23625.23
2-Jan-23,Padma,Clean 100ml,250,20,1,21,940,18800,14751.99
31-Dec-22,Padma,Clean 100ml,250,20,1,21,940,18800,19655.29
28-Dec-22,Padma,Clean 100ml,250,100,10,110,940,94000,101378.81
27-Dec-22,Padma,Gentech - P.S (20 LTr.),0,50,7,57,11700,585000,163928
26-Dec-22,Padma,Clean 100ml,250,20,1,21,940,18800,88811.05
26-Dec-22,Padma,Clean 100ml,250,20,1,21,940,18800,22420.42
26-Dec-22,Padma,Clean 100ml,250,20,1,21,940,18800,14655.28
26-Dec-22,Padma,Clean 100ml,250,50,4,54,940,47000,39010
19-Dec-22,Padma,Clean 100ml,250,100,11,111,940,94000,43984.27
13-Dec-22,Padma,Gentech - P.S (20 LTr.),0,5,0,5,11700,58500,163928
13-Dec-22,Padma,Clean 100ml,250,20,1,21,940,18800,90812.65
13-Dec-22,Padma,Clean 100ml,250,2,0,2,940,1880,21894.48
13-Dec-22,Padma,Clean 100ml,250,20,1,21,940,18800,26586.07
8-Dec-22,Padma,Clean 100ml,250,20,1,21,940,18800,24153.28
14-Nov-22,Padma,Clean 100ml,250,3,0,3,940,2820,75824.21
14-Nov-22,Padma,Clean 100ml,250,8,0,8,940,7520,75824.21
14-Nov-22,Padma,Clean 100ml,250,11,0,11,940,10340,75824.21
14-Nov-22,Padma,Clean 100ml,250,18,3,21,940,16920,75824.21
12-Nov-22,Padma,Clean 100ml,250,18,1,19,940,16920,30161.12
8-Nov-22,Padma,Gentech - P.S (20 LTr.),0,1,0,1,11700,11700,23613.4
31-Oct-22,Padma,Gentech - P.S (20 LTr.),0,1,0,1,11700,11700,101378.81
31-Oct-22,Padma,Clean 100ml,250,3,0,3,940,2820,101378.81
25-Oct-22,Padma,Gentech - P.S (20 LTr.),0,5,0,5,11700,58500,163928
15-Oct-22,Padma,Gentech - P.S (20 LTr.),0,6,0,6,11700,70200,28621.51
12-Oct-22,Padma,Fresmin F 10kg,2178,1,0,1,4595,4595,15444.62
10-Oct-22,Padma,Clean 100ml,250,15,1,16,940,14100,43984.27
29-Sep-22,Padma,Clean 100ml,250,15,1,16,940,14100,17905.92
21-Sep-22,Padma,Clean 100ml,250,13,0,13,940,12220,13664.63
21-Sep-22,Padma,Clean 100ml,250,7,1,8,940,6580,13664.63
20-Sep-22,Padma,Clean 100ml,250,15,1,16,940,14100,17483.95
14-Sep-22,Padma,Clean 100ml,250,20,1,21,940,18800,40997.5
11-Sep-22,Padma,Clean 100ml,250,20,1,21,940,18800,16339.31
28-Aug-22,Padma,Clean 100ml,250,5,0,5,940,4700,42380.34
28-Aug-22,Padma,Clean 100ml,250,12,0,12,940,11280,19655.29
28-Aug-22,Padma,Clean 100ml,250,8,1,9,940,7520,19655.29
25-Aug-22,Padma,Clean 100ml,250,20,1,21,940,18800,23625.23
25-Aug-22,Padma,Clean 100ml,250,20,1,21,940,18800,24153.28
25-Aug-22,Padma,Clean 100ml,250,100,0,100,940,94000,88811.05
25-Aug-22,Padma,Clean 100ml,250,0,12,12,940,0,88811.05
25-Aug-22,Padma,Clean 100ml,250,50,5,55,940,47000,101378.81
23-Aug-22,Padma,Clean 100ml,250,60,5,65,940,56400,36155.34
23-Aug-22,Padma,Clean 100ml,250,40,3,43,940,37600,75824.21
20-Aug-22,Padma,Clean 100ml,250,100,12,112,940,94000,104696.05
20-Aug-22,Padma,Clean 100ml,250,100,11,111,940,94000,102001.3
13-Aug-22,Padma,Clean 100ml,250,40,3,43,940,37600,104696.05
10-Aug-22,Padma,Clean 100ml,250,8,0,8,940,7520,17905.92
7-Aug-22,Padma,Clean 100ml,250,40,3,43,940,37600,27484.57
7-Aug-22,Padma,Clean 100ml,250,20,1,21,940,18800,23483.22
7-Aug-22,Padma,Clean 100ml,250,20,1,21,940,18800,20132.96
4-Aug-22,Padma,Clean 100ml,250,20,1,21,940,18800,19655.29
3-Aug-22,Padma,Clean 100ml,250,40,3,43,940,37600,24153.28
2-Aug-22,Padma,Clean 100ml,250,20,1,21,940,18800,26729.97
2-Aug-22,Padma,Clean 100ml,250,60,5,65,940,56400,45766
2-Aug-22,Padma,Clean 100ml,250,6,0,6,940,5640,16017.86
2-Aug-22,Padma,Clean 100ml,250,54,5,59,940,50760,16017.86
2-Aug-22,Padma,Clean 100ml,250,20,1,21,940,18800,33025.96
31-Jul-22,Padma,Clean 100ml,250,10,0,10,940,9400,16339.31
28-Jul-22,Padma,Clean 100ml,250,100,11,111,940,94000,70415.33
28-Jul-22,Padma,Clean 100ml,250,20,1,21,940,18800,32278.93
27-Jul-22,Padma,Clean 100ml,250,4,0,4,940,3760,19839.26
27-Jul-22,Padma,Clean 100ml,250,20,1,21,940,18800,22420.42
26-Jul-22,Padma,Clean 100ml,250,10,0,10,940,9400,16533.4
20-Jun-22,Padma,Clean 100ml,1,1,0,1,940,940,33025.96
15-Jun-22,Padma,Clean 100ml,1,5,0,5,940,4700,88811.05
24-May-22,Padma,Clean 100ml,250,5,0,5,940,4700,14655.28
19-May-22,Padma,Clean 100ml,250,10,0,10,940,9400,15201.19
12-May-22,Padma,Clean 100ml,250,15,1,16,940,14100,24153.28
11-May-22,Padma,Clean 100ml,250,5,0,5,940,4700,52828.85
11-May-22,Padma,Clean 100ml,250,20,1,21,940,18800,33025.96
11-May-22,Padma,Clean 100ml,250,20,1,21,940,18800,55448.86
11-May-22,Padma,Clean 100ml,250,20,1,21,940,18800,16339.31
9-May-22,Padma,Clean 100ml,1,1,0,1,940,940,14655.28
8-May-22,Padma,Clean 100ml,250,20,1,21,940,18800,27755.2
26-Apr-22,Padma,Clean 100ml,1,40,3,43,940,37600,24380.2
24-Apr-22,Padma,Clean 100ml,1,20,1,21,940,18800,13191.81
24-Apr-22,Padma,Clean 100ml,1,5,0,5,940,4700,16533.4
24-Apr-22,Padma,Clean 100ml,1,10,0,10,940,9400,13664.63
24-Apr-22,Padma,Clean 100ml,1,5,0,5,940,4700,15444.62
24-Apr-22,Padma,Clean 100ml,1,20,1,21,940,18800,26729.97
24-Apr-22,Padma,Clean 100ml,1,20,1,21,940,18800,30161.12
24-Apr-22,Padma,Clean 100ml,1,10,0,10,940,9400,24153.28
23-Apr-22,Padma,Clean 100ml,1,100,12,112,940,94000,70415.33
23-Apr-22,Padma,Clean 100ml,1,120,13,133,940,112800,50584.55
23-Apr-22,Padma,Clean 100ml,1,10,0,10,940,9400,102001.3
11-Jul-23,R&D Center,Viusid Aqua 150ml,1600,6,0,6,1075,6450,42800
22-Oct-23,Rupsha,Vivapond Plus (1kg),5,1,0,1,6600,6600,263810.48
19-Oct-23,Rupsha,Clean 100ml,250,40,3,43,940,37600,47482.12
16-Oct-23,Rupsha,Vivapond Plus (1kg),5,1,0,1,6600,6600,263810.48
14-Oct-23,Rupsha,Clean 100ml,250,17,1,18,940,15980,20421.83
14-Oct-23,Rupsha,Clean 100ml,250,3,0,3,940,2820,20421.83
10-Oct-23,Rupsha,Vivabond (5Ltr.),1,2,0,2,2350,4700,10864.68
3-Oct-23,Rupsha,Clean 100ml,250,12,0,12,940,11280,9375.04
30-Sep-23,Rupsha,Vivapond Plus (1kg),5,3,0,3,6600,19800,263810.48
30-Sep-23,Rupsha,Vivamin (10kg),5,2,0,2,2150,4300,263810.48
28-Sep-23,Rupsha,Clean 100ml,250,14,0,14,940,13160,9375.04
24-Sep-23,Rupsha,Gentech - P.S (20 LTr.),0,1,0,1,11700,11700,42992.4
23-Sep-23,Rupsha,Clean 100ml,250,3,0,3,940,2820,9375.04
23-Sep-23,Rupsha,Vivabond (5Ltr.),1,5,0,5,2350,11750,40942.43
21-Sep-23,Rupsha,Vivapond Plus (1kg),5,1,0,1,6600,6600,194627.99
21-Sep-23,Rupsha,Gentech - P.S (20 LTr.),0,1,0,1,11700,11700,194627.99
19-Sep-23,Rupsha,Vivapond Plus (1kg),1,1,0,1,6600,6600,263810.48
14-Sep-23,Rupsha,Vivapond Plus (1kg),5,3,0,3,6600,19800,263810.48
11-Sep-23,Rupsha,Vivamin (10kg),5,1,0,1,2150,2150,24508.15
10-Sep-23,Rupsha,Clean 100ml,250,100,11,111,940,94000,131917.13
10-Sep-23,Rupsha,Clean 100ml,250,4,0,4,940,3760,18014.34
5-Sep-23,Rupsha,Clean 100ml,250,6,0,6,940,5640,8331.36
4-Sep-23,Rupsha,Clean 100ml,250,20,1,21,940,18800,25985.62
30-Aug-23,Rupsha,Clean 100ml,250,3,0,3,940,2820,24508.15
28-Aug-23,Rupsha,Clean 100ml,250,8,0,8,940,7520,24508.15
24-Aug-23,Rupsha,Vivapond Plus (1kg),5,5,0,5,6600,33000,54218.8
24-Aug-23,Rupsha,Clean 100ml,250,20,1,21,940,18800,40942.43
22-Aug-23,Rupsha,Vivapond Plus (1kg),5,6,0,6,6600,39600,16783.25
21-Aug-23,Rupsha,Vivabond (5Ltr.),1,1,0,1,2350,2350,10864.68
21-Aug-23,Rupsha,Gentech - P.S (20 LTr.),0,2,0,2,11700,23400,21201.64
19-Aug-23,Rupsha,Gentech - P.S (20 LTr.),0,1,0,1,11700,11700,133535.23
19-Aug-23,Rupsha,Gentech - P.S (20 LTr.),0,1,0,1,11700,11700,18014.34
19-Aug-23,Rupsha,Gentech - P.S (20 LTr.),0,3,0,3,11700,35100,263810.48
17-Aug-23,Rupsha,Clean 100ml,250,10,0,10,940,9400,17913.91
16-Aug-23,Rupsha,Gentech - P.S (20 LTr.),0,1,0,1,11700,11700,42992.4
16-Aug-23,Rupsha,Vivapond Plus (1kg),1,1,0,1,6600,6600,42992.4
14-Aug-23,Rupsha,Vivabond (5Ltr.),1,1,0,1,2350,2350,24508.15
14-Aug-23,Rupsha,Vivapond Plus (1kg),1,1,0,1,6600,6600,7917.54
12-Aug-23,Rupsha,Gentech - P.S (20 LTr.),0,2,0,2,11700,23400,263810.48
8-Aug-23,Rupsha,Clean 100ml,250,20,0,20,940,18800,12103.68
7-Aug-23,Rupsha,Clean 100ml,250,20,1,21,940,18800,20421.83
7-Aug-23,Rupsha,Clean 100ml,250,5,0,5,940,4700,11855.04
5-Aug-23,Rupsha,Viusid Aqua 500ml,1,1,0,1,2750,2750,47482.12
5-Aug-23,Rupsha,Vivapond Plus (1kg),5,5,0,5,6600,33000,89710.7
5-Aug-23,Rupsha,Vivamin (10kg),5,20,2,22,2150,43000,89710.7
5-Aug-23,Rupsha,Clean 100ml,250,100,14,114,940,94000,131917.13
3-Aug-23,Rupsha,Vivapond Plus (1kg),1,2,0,2,6600,13200,42992.4
2-Aug-23,Rupsha,Clean 100ml,250,5,0,5,940,4700,35319.65
2-Aug-23,Rupsha,Clean 100ml,250,2,0,2,940,1880,8331.36
1-Aug-23,Rupsha,Vivamin (10kg),5,25,2,27,2150,53750,86872.62
1-Aug-23,Rupsha,Vivabond (5Ltr.),1,4,0,4,2350,9400,86872.62
30-Jul-23,Rupsha,Vivapond Plus (1kg),5,12,1,13,6600,79200,263810.48
26-Jul-23,Rupsha,Vivapond Plus (1kg),5,12,1,13,6600,79200,263810.48
25-Jul-23,Rupsha,Vivabond (5Ltr.),1,2,0,2,2350,4700,78076.29
23-Jul-23,Rupsha,Vivabond (5Ltr.),1,2,0,2,2350,4700,89710.7
23-Jul-23,Rupsha,Clean 100ml,250,10,0,10,940,9400,9108.44
18-Jul-23,Rupsha,Gentech - P.S (20 LTr.),0,20,2,22,11700,234000,280068.66
12-Jul-23,Rupsha,Viusid Aqua 500ml,1,7,0,7,2750,19250,24508.15
12-Jul-23,Rupsha,Vivabond (5Ltr.),1,1,0,1,2350,2350,15644.98
12-Jul-23,Rupsha,Vivabond (5Ltr.),1,4,0,4,2350,9400,89710.7
9-Jul-23,Rupsha,Vivabond (5Ltr.),1,8,0,8,2350,18800,86872.62
2-Jul-23,Rupsha,Viusid Aqua 500ml,1,1,0,1,2750,2750,194627.99
24-Jun-23,Rupsha,Gentech - P.S (20 LTr.),0,12,1,13,11700,140400,280068.66
24-Jun-23,Rupsha,Vivabond (5Ltr.),1,4,0,4,2350,9400,86872.62
24-Jun-23,Rupsha,Clean 100ml,250,99,12,111,940,93060,131917.13
24-Jun-23,Rupsha,Clean 100ml,250,1,0,1,940,940,131917.13
21-Jun-23,Rupsha,Viusid Aqua 500ml,1,1,0,1,2750,2750,42992.4
18-Jun-23,Rupsha,Viusid Aqua 500ml,1,2,0,2,2750,5500,263810.48
17-Jun-23,Rupsha,Vivapond Plus (1kg),1,2,0,2,6600,13200,133535.23
15-Jun-23,Rupsha,Viusid Aqua 500ml,1,1,0,1,2750,2750,42992.4
15-Jun-23,Rupsha,Vivapond Plus (1kg),1,1,0,1,6600,6600,7917.54
13-Jun-23,Rupsha,Viusid Aqua 500ml,1,4,0,4,2750,11000,88245.17
11-Jun-23,Rupsha,Vivapond Plus (1kg),1,1,0,1,6600,6600,47482.12
11-Jun-23,Rupsha,Clean 100ml,250,1,0,1,940,940,8331.36
11-Jun-23,Rupsha,Viusid Aqua 500ml,1,5,0,5,2750,13750,24508.15
8-Jun-23,Rupsha,Clean 100ml,250,20,1,21,940,18800,28832.94
8-Jun-23,Rupsha,Vivapond Plus (1kg),1,12,1,13,6600,79200,263810.48
8-Jun-23,Rupsha,Vivapond Plus (1kg),1,2,0,2,6600,13200,42992.4
6-Jun-23,Rupsha,Vivabond (5Ltr.),1,4,0,4,2350,9400,86872.62
6-Jun-23,Rupsha,Vivamin (10kg),1,6,0,6,2150,12900,89710.7
6-Jun-23,Rupsha,Vivamin (10kg),5,4,1,5,2150,8600,89710.7
6-Jun-23,Rupsha,Vivapond Plus (1kg),1,3,0,3,6600,19800,89710.7
6-Jun-23,Rupsha,Viusid Aqua 500ml,1,6,0,6,2750,16500,89710.7
6-Jun-23,Rupsha,Vivabond (5Ltr.),1,4,0,4,2350,9400,89710.7
6-Jun-23,Rupsha,Clean 100ml,250,7,0,7,940,6580,4204.03
6-Jun-23,Rupsha,Clean 100ml,250,5,0,5,940,4700,17913.91
6-Jun-23,Rupsha,Viusid Aqua 500ml,1,3,0,3,2750,8250,13869.58
6-Jun-23,Rupsha,Vivapond Plus (1kg),1,12,1,13,6600,79200,263810.48
29-May-23,Rupsha,Clean 100ml,250,2,0,2,940,1880,18014.34
25-May-23,Rupsha,Vivapond Plus (1kg),1,1,0,1,6600,6600,42992.4
25-May-23,Rupsha,Vivamin (10kg),1,2,0,2,2150,4300,42992.4
22-May-23,Rupsha,Vivamin (10kg),1,10,1,11,2150,21500,89710.7
22-May-23,Rupsha,Vivapond Plus (1kg),1,3,0,3,6600,19800,89710.7
22-May-23,Rupsha,Viusid Aqua 500ml,1,6,0,6,2750,16500,89710.7
20-May-23,Rupsha,Clean 100ml,250,10,0,10,940,9400,24037.21
18-May-23,Rupsha,Viusid Aqua 500ml,1,12,1,13,2750,33000,86872.62
18-May-23,Rupsha,Vivabond (5Ltr.),1,6,0,6,2350,14100,86872.62
18-May-23,Rupsha,Vivamin (10kg),1,1,0,1,2150,2150,147239.15
18-May-23,Rupsha,Vivapond Plus (1kg),1,1,0,1,6600,6600,147239.15
18-May-23,Rupsha,Viusid Aqua 500ml,1,1,0,1,2750,2750,147239.15
17-May-23,Rupsha,Viusid Aqua 500ml,1,1,0,1,2750,2750,24508.15
15-May-23,Rupsha,Vivapond Plus (1kg),1,1,0,1,6600,6600,42992.4
15-May-23,Rupsha,Vivabond (5Ltr.),1,1,0,1,2350,2350,42992.4
15-May-23,Rupsha,Vivamin (10kg),1,1,0,1,2150,2150,42992.4
15-May-23,Rupsha,Vivamin (10kg),1,30,3,33,2150,64500,280068.66
15-May-23,Rupsha,Vivapond Plus (1kg),1,12,1,13,6600,79200,280068.66
14-May-23,Rupsha,Viusid Aqua 500ml,1,6,0,6,2750,16500,13869.58
8-May-23,Rupsha,Vivapond Plus (1kg),1,12,1,13,6600,79200,263810.48
6-May-23,Rupsha,Vivamin (10kg),1,1,0,1,2150,2150,7917.54
4-May-23,Rupsha,Vivamin (10kg),1,2,0,2,2150,4300,42992.4
4-May-23,Rupsha,Vivapond Plus (1kg),1,1,0,1,6600,6600,42992.4
4-May-23,Rupsha,Gentech - P.S (20 LTr.),0,10,1,11,11700,117000,86872.62
4-May-23,Rupsha,Vivamin (10kg),1,20,1,21,2150,43000,86872.62
4-May-23,Rupsha,Vivabond (5Ltr.),1,3,0,3,2350,7050,86872.62
2-May-23,Rupsha,Vivamin (10kg),1,5,0,5,2150,10750,24508.15
27-Apr-23,Rupsha,Clean 100ml,250,50,4,54,940,47000,78076.29
19-Apr-23,Rupsha,Clean 100ml,250,1,0,1,940,940,8331.36
19-Apr-23,Rupsha,Viusid Aqua 500ml,1,2,0,2,2750,5500,42992.4
18-Apr-23,Rupsha,Vivamin (10kg),1,1,0,1,2150,2150,7063.95
18-Apr-23,Rupsha,Viusid Aqua 500ml,1,12,1,13,2750,33000,86872.62
18-Apr-23,Rupsha,Gentech - P.S (20 LTr.),0,12,1,13,11700,140400,86872.62
16-Apr-23,Rupsha,Vivamin (10kg),1,10,0,10,2150,21500,89710.7
16-Apr-23,Rupsha,Viusid Aqua 500ml,1,12,1,13,2750,33000,13869.58
13-Apr-23,Rupsha,Clean 100ml,250,20,1,21,940,18800,78076.29
13-Apr-23,Rupsha,Clean 100ml,250,20,1,21,940,18800,9826.59
11-Apr-23,Rupsha,Vivamin (10kg),1,12,1,13,2150,25800,263810.48
11-Apr-23,Rupsha,Vivamin (10kg),1,5,0,5,2150,10750,24508.15
8-Apr-23,Rupsha,Vivamin (10kg),1,1,0,1,2150,2150,7063.95
8-Apr-23,Rupsha,Viusid Aqua 500ml,1,6,0,6,2750,16500,32806.08
8-Apr-23,Rupsha,Vivamin (10kg),1,13,0,13,2150,27950,24508.15
6-Apr-23,Rupsha,Clean 100ml,250,60,5,65,940,56400,99070.01
4-Apr-23,Rupsha,Viusid Aqua 500ml,1,1,0,1,2750,2750,60481.67
4-Apr-23,Rupsha,Clean 100ml,250,20,1,21,940,18800,20421.83
3-Apr-23,Rupsha,Vivapond Plus (1kg),1,12,1,13,6600,79200,263810.48
3-Apr-23,Rupsha,Vivabond (5Ltr.),1,4,0,4,2350,9400,89710.7
3-Apr-23,Rupsha,Viusid Aqua 500ml,1,5,0,5,2750,13750,89710.7
3-Apr-23,Rupsha,Vivapond Plus (1kg),1,3,0,3,6600,19800,89710.7
2-Apr-23,Rupsha,Vivamin (10kg),1,20,1,21,2150,43000,86872.62
2-Apr-23,Rupsha,Viusid Aqua 500ml,1,12,1,13,2750,33000,86872.62
2-Apr-23,Rupsha,Vivapond Plus (1kg),1,30,2,32,6600,198000,86872.62
2-Apr-23,Rupsha,Gentech - P.S (20 LTr.),0,12,1,13,11700,140400,86872.62
2-Apr-23,Rupsha,Clean 100ml,250,30,2,32,940,28200,40942.43
1-Apr-23,Rupsha,Vivapond Plus (1kg),1,1,0,1,6600,6600,42992.4
1-Apr-23,Rupsha,Vivamin (10kg),1,4,0,4,2150,8600,42992.4
27-Mar-23,Rupsha,Vivamin (10kg),1,1,0,1,2150,2150,133535.23
27-Mar-23,Rupsha,Viusid Aqua 500ml,1,10,0,10,2750,27500,133535.23
27-Mar-23,Rupsha,Viusid Aqua 500ml,1,6,0,6,2750,16500,86872.62
27-Mar-23,Rupsha,Vivamin (10kg),1,30,2,32,2150,64500,86872.62
27-Mar-23,Rupsha,Vivamin (10kg),1,4,0,4,2150,8600,11855.04
25-Mar-23,Rupsha,Viusid Aqua 500ml,1,2,0,2,2750,5500,89710.7
25-Mar-23,Rupsha,Clean 100ml,250,20,1,21,940,18800,89710.7
19-Mar-23,Rupsha,Viusid Aqua 500ml,1,24,2,26,2750,66000,13869.58
18-Mar-23,Rupsha,Clean 100ml,250,20,1,21,940,18800,9826.59
16-Mar-23,Rupsha,Viusid Aqua 500ml,1,12,1,13,2750,33000,40942.43
15-Mar-23,Rupsha,Viusid Aqua 500ml,1,4,0,4,2750,11000,280068.66
15-Mar-23,Rupsha,Vivapond Plus (1kg),1,10,1,11,6600,66000,280068.66
15-Mar-23,Rupsha,Gentech - P.S (20 LTr.),0,10,1,11,11700,117000,280068.66
15-Mar-23,Rupsha,Vivapond Plus (1kg),1,2,0,2,6600,13200,42992.4
15-Mar-23,Rupsha,Vivamin (10kg),1,2,0,2,2150,4300,42992.4
14-Mar-23,Rupsha,Clean 100ml,250,20,1,21,940,18800,25985.62
14-Mar-23,Rupsha,Vivapond Plus (1kg),1,12,1,13,6600,79200,86872.62
14-Mar-23,Rupsha,Clean 100ml,250,100,10,110,940,94000,99070.01
12-Mar-23,Rupsha,Clean 100ml,250,10,0,10,940,9400,9826.59
7-Mar-23,Rupsha,Clean 100ml,250,50,5,55,940,47000,99070.01
5-Mar-23,Rupsha,Clean 100ml,250,50,4,54,940,47000,78076.29
2-Mar-23,Rupsha,Clean 100ml,250,20,1,21,940,18800,78076.29
2-Mar-23,Rupsha,Clean 100ml,250,3,0,3,940,2820,10890.47
2-Mar-23,Rupsha,Clean 100ml,250,11,0,11,940,10340,20421.83
28-Feb-23,Rupsha,Clean 100ml,250,2,0,2,940,1880,25882.25
19-Feb-23,Rupsha,Gentech - P.S (20 LTr.),0,1,0,1,11700,11700,21201.64
18-Feb-23,Rupsha,Clean 100ml,250,20,1,21,940,18800,24037.21
15-Feb-23,Rupsha,Clean 100ml,250,10,0,10,940,9400,78076.29
15-Feb-23,Rupsha,Clean 100ml,250,5,0,5,940,4700,4204.03
14-Feb-23,Rupsha,Clean 100ml,250,10,0,10,940,9400,28832.94
11-Feb-23,Rupsha,Clean 100ml,250,1,0,1,940,940,25985.62
7-Feb-23,Rupsha,Clean 100ml,250,3,0,3,940,2820,4204.03
4-Feb-23,Rupsha,Clean 100ml,250,110,13,123,940,103400,99070.01
2-Feb-23,Rupsha,Clean 100ml,250,25,1,26,940,23500,23429.16
1-Feb-23,Rupsha,Clean 100ml,250,5,0,5,940,4700,25985.62
30-Jan-23,Rupsha,Clean 100ml,250,20,1,21,940,18800,89710.7
30-Jan-23,Rupsha,Clean 100ml,250,2,0,2,940,1880,9404.92
25-Jan-23,Rupsha,Clean 100ml,250,20,1,21,940,18800,13111.92
23-Jan-23,Rupsha,Clean 100ml,250,4,0,4,940,3760,89710.7
22-Jan-23,Rupsha,Gentech - P.S (20 LTr.),0,3,0,3,11700,35100,86872.62
17-Jan-23,Rupsha,Clean 100ml,250,4,0,4,940,3760,4204.03
15-Jan-23,Rupsha,Clean 100ml,250,5,0,5,940,4700,24508.15
9-Jan-23,Rupsha,Clean 100ml,250,110,13,123,940,103400,99070.01
28-Dec-22,Rupsha,Clean 100ml,250,10,0,10,940,9400,24037.21
27-Dec-22,Rupsha,Clean 100ml,250,100,11,111,940,94000,99070.01
13-Dec-22,Rupsha,Clean 100ml,250,20,1,21,940,18800,47482.12
27-Oct-22,Rupsha,Gentech - P.S (20 LTr.),0,1,0,1,11700,11700,86872.62
16-Oct-22,Rupsha,Fresmin F 10kg,2178,2,0,2,4595,9190,24958.65
29-Sep-22,Rupsha,Gentech - P.S (20 LTr.),0,2,0,2,11700,23400,86872.62
1-Sep-22,Rupsha,Clean 100ml,250,36,0,36,940,33840,24037.21
25-Aug-22,Rupsha,Clean 100ml,250,3,0,3,940,2820,4279.68
20-Aug-22,Rupsha,Clean 100ml,250,11,0,11,940,10340,10357.26
20-Aug-22,Rupsha,Clean 100ml,250,9,1,10,940,8460,10357.26
3-Aug-22,Rupsha,Clean 100ml,250,1,0,1,940,940,3853.7
3-Aug-22,Rupsha,Clean 100ml,250,4,0,4,940,3760,9404.92
2-Aug-22,Rupsha,Clean 100ml,250,24,1,25,940,22560,47482.12
1-Aug-22,Rupsha,Clean 100ml,250,3,0,3,940,2820,17913.91
26-Jul-22,Rupsha,Clean 100ml,250,6,0,6,940,5640,12103.68
16-May-22,Rupsha,Clean 100ml,1,4,0,4,940,3760,6222.72
9-May-22,Rupsha,Clean 100ml,1,10,0,10,940,9400,10357.26
8-May-22,Rupsha,Clean 100ml,1,7,0,7,940,6580,11323.86
8-May-22,Rupsha,Clean 100ml,1,5,0,5,940,4700,24508.15
25-Oct-23,Surma,Clean 100ml,250,20,1,21,940,18800,17856.07
21-Oct-23,Surma,Clean 100ml,250,1,0,1,940,940,24126.24
21-Oct-23,Surma,Clean 100ml,250,99,15,114,940,93060,24126.24
17-Oct-23,Surma,Clean 100ml,250,17,1,18,940,15980,38699.44
16-Oct-23,Surma,Clean 100ml,250,60,5,65,940,56400,53487.89
15-Oct-23,Surma,Clean 100ml,250,4,0,4,940,3760,24126.24
15-Oct-23,Surma,Clean 100ml,250,4,0,4,940,3760,24126.24
15-Oct-23,Surma,Clean 100ml,250,92,15,107,940,86480,24126.24
14-Oct-23,Surma,Clean 100ml,250,10,0,10,940,9400,38699.44
10-Oct-23,Surma,Clean 100ml,250,20,1,21,940,18800,27757.97
3-Oct-23,Surma,Clean 100ml,250,20,1,21,940,18800,24926.84
3-Oct-23,Surma,Clean 100ml,250,10,0,10,940,9400,24126.24
2-Oct-23,Surma,Clean 100ml,250,10,0,10,940,9400,17856.07
30-Sep-23,Surma,Clean 100ml,250,10,0,10,940,9400,16751.56
27-Sep-23,Surma,Clean 100ml,250,46,4,50,940,43240,45167.52
24-Sep-23,Surma,Clean 100ml,250,4,0,4,940,3760,2363.68
20-Sep-23,Surma,Clean 100ml,250,25,1,26,940,23500,30879.72
20-Sep-23,Surma,Clean 100ml,250,5,0,5,940,4700,17856.07
17-Sep-23,Surma,Clean 100ml,250,9,0,9,940,8460,34432.84
6-Sep-23,Surma,Clean 100ml,250,25,1,26,940,23500,30132.93
6-Sep-23,Surma,Clean 100ml,250,6,0,6,940,5640,10196.49
5-Sep-23,Surma,Clean 100ml,250,60,5,65,940,56400,53487.89
30-Aug-23,Surma,Clean 100ml,250,2,0,2,940,1880,17856.07
29-Aug-23,Surma,Clean 100ml,250,35,2,37,940,32900,30286.7
20-Aug-23,Surma,Clean 100ml,250,46,4,50,940,43240,45167.52
19-Aug-23,Surma,Clean 100ml,250,20,0,20,940,18800,24126.24
19-Aug-23,Surma,Clean 100ml,250,20,3,23,940,18800,24126.24
19-Aug-23,Surma,Clean 100ml,250,40,3,43,940,37600,38699.44
19-Aug-23,Surma,Clean 100ml,250,60,7,67,940,56400,38699.44
17-Aug-23,Surma,Clean 100ml,250,3,0,3,940,2820,27148.09
6-Aug-23,Surma,Clean 100ml,250,1,0,1,940,940,24126.24
3-Aug-23,Surma,Clean 100ml,250,25,1,26,940,23500,27148.09
31-Jul-23,Surma,Clean 100ml,250,5,0,5,940,4700,34432.84
31-Jul-23,Surma,Clean 100ml,250,7,0,7,940,6580,34432.84
25-Jul-23,Surma,Clean 100ml,250,20,1,21,940,18800,24126.24
23-Jul-23,Surma,Clean 100ml,250,40,2,42,940,37600,30286.7
19-Jul-23,Surma,Clean 100ml,250,9,0,9,940,8460,18714.42
18-Jul-23,Surma,Clean 100ml,250,6,0,6,940,5640,10196.49
14-Jul-23,Surma,Clean 100ml,250,10,0,10,940,9400,16751.56
9-Jul-23,Surma,Clean 100ml,250,30,2,32,940,28200,39602.24
6-Jul-23,Surma,Clean 100ml,250,1,0,1,940,940,30132.93
6-Jul-23,Surma,Clean 100ml,250,24,1,25,940,22560,30132.93
2-Jul-23,Surma,Clean 100ml,250,35,2,37,940,32900,27824.16
18-Jun-23,Surma,Clean 100ml,250,18,0,18,940,16920,53487.89
18-Jun-23,Surma,Clean 100ml,250,42,5,47,940,39480,53487.89
18-Jun-23,Surma,Clean 100ml,250,25,1,26,940,23500,30879.72
7-Jun-23,Surma,Clean 100ml,250,100,15,115,940,94000,24126.24
6-Jun-23,Surma,Clean 100ml,250,10,0,10,940,9400,16618.05
23-May-23,Surma,Clean 100ml,250,5,0,5,940,4700,39602.24
10-May-23,Surma,Clean 100ml,250,40,3,43,940,37600,24126.24
8-May-23,Surma,Clean 100ml,250,20,1,21,940,18800,27757.97
4-May-23,Surma,Clean 100ml,250,5,0,5,940,4700,38699.44
4-May-23,Surma,Clean 100ml,250,25,2,27,940,23500,38699.44
18-Apr-23,Surma,Clean 100ml,250,50,5,55,940,47000,68371.32
12-Apr-23,Surma,Clean 100ml,250,10,0,10,940,9400,15618.52
6-Apr-23,Surma,Clean 100ml,250,100,15,115,940,94000,30579.62
2-Apr-23,Surma,Clean 100ml,250,60,5,65,940,56400,53487.89
11-Mar-23,Surma,Clean 100ml,250,15,1,16,940,14100,22002.31
7-Mar-23,Surma,Clean 100ml,250,38,3,41,940,35720,27148.09
7-Mar-23,Surma,Clean 100ml,250,2,0,2,940,1880,27148.09
7-Mar-23,Surma,Clean 100ml,250,20,1,21,940,18800,20608.73
6-Mar-23,Surma,Clean 100ml,250,40,3,43,940,37600,30879.72
27-Feb-23,Surma,Clean 100ml,250,60,6,66,940,56400,24126.24
26-Feb-23,Surma,Clean 100ml,250,20,1,21,940,18800,45167.52
12-Feb-23,Surma,Clean 100ml,250,30,1,31,940,28200,38699.44
5-Feb-23,Surma,Clean 100ml,250,20,1,21,940,18800,38699.44
25-Jan-23,Surma,Clean 100ml,250,40,3,43,940,37600,53487.89
22-Jan-23,Surma,Clean 100ml,250,20,1,21,940,18800,27757.97
15-Jan-23,Surma,Clean 100ml,250,20,1,21,940,18800,22002.31
12-Jan-23,Surma,Clean 100ml,250,12,0,12,940,11280,38699.44
11-Jan-23,Surma,Clean 100ml,250,20,1,21,940,18800,24126.24
7-Jan-23,Surma,Clean 100ml,250,60,5,65,940,56400,24126.24
4-Jan-23,Surma,Clean 100ml,250,40,3,43,940,37600,30579.62
1-Jan-23,Surma,Clean 100ml,250,20,1,21,940,18800,16568.88
28-Dec-22,Surma,Clean 100ml,250,10,0,10,940,9400,24357.17
28-Dec-22,Surma,Clean 100ml,250,40,3,43,940,37600,53487.89
21-Dec-22,Surma,Clean 100ml,250,10,0,10,940,9400,30579.62
13-Dec-22,Surma,Clean 100ml,250,20,1,21,940,18800,30286.7
19-Nov-22,Surma,Clean 100ml,250,20,1,21,940,18800,16568.88
12-Nov-22,Surma,Clean 100ml,250,200,23,223,940,188000,24126.24
12-Nov-22,Surma,Clean 100ml,250,0,7,7,940,0,24126.24
27-Oct-22,Surma,Clean 100ml,250,40,0,40,940,37600,68371.32
27-Oct-22,Surma,Clean 100ml,250,4,0,4,940,3760,68371.32
27-Oct-22,Surma,Clean 100ml,250,1,5,6,940,940,68371.32
2-Oct-22,Surma,Clean 100ml,250,7,0,7,940,6580,15618.52
26-Sep-22,Surma,Clean 100ml,250,40,2,42,940,37600,24126.24
26-Sep-22,Surma,Clean 100ml,250,25,1,26,940,23500,27148.09
17-Sep-22,Surma,Clean 100ml,250,6,0,6,940,5640,24126.24
1-Sep-22,Surma,Clean 100ml,250,20,1,21,940,18800,24126.24
28-Aug-22,Surma,Clean 100ml,250,10,0,10,940,9400,24357.17
18-Aug-22,Surma,Clean 100ml,250,4,0,4,940,3760,24126.24
18-Aug-22,Surma,Clean 100ml,250,21,1,22,940,19740,24126.24
8-Aug-22,Surma,Clean 100ml,250,10,0,10,940,9400,24126.24
6-Aug-22,Surma,Clean 100ml,250,25,1,26,940,23500,24126.24
3-Aug-22,Surma,Clean 100ml,250,40,3,43,940,37600,39602.24
3-Aug-22,Surma,Clean 100ml,250,40,3,43,940,37600,68371.32
30-Jul-22,Surma,Clean 100ml,250,25,1,26,940,23500,27148.09
28-Jul-22,Surma,Clean 100ml,250,10,0,10,940,9400,20608.73
16-May-22,Surma,Clean 100ml,1,40,2,42,940,37600,16618.05
9-May-22,Surma,Clean 100ml,1,5,0,5,940,4700,24279.87
9-May-22,Surma,Clean 100ml,1,5,0,5,940,4700,24357.17
28-Apr-22,Surma,Clean 100ml,1,20,1,21,940,18800,24126.24
25-Apr-22,Surma,Clean 100ml,1,20,1,21,940,18800,16618.05
24-Apr-22,Surma,Clean 100ml,1,25,1,26,940,23500,34432.84
17-Oct-23,Tista,Clean 100ml,250,20,1,21,940,18800,29123.65
15-Oct-23,Tista,Clean 100ml,250,5,0,5,940,4700,9452.39
19-Sep-23,Tista,Clean 100ml,250,100,11,111,940,94000,87161.63
7-Sep-23,Tista,Clean 100ml,250,20,1,21,940,18800,21946.46
5-Sep-23,Tista,Clean 100ml,250,10,0,10,940,9400,12264.21
4-Sep-23,Tista,Clean 100ml,250,40,3,43,940,37600,72218.95
26-Aug-23,Tista,Clean 100ml,250,20,1,21,940,18800,31282.74
22-Aug-23,Tista,Clean 100ml,250,6,0,6,940,5640,9452.39
22-Aug-23,Tista,Clean 100ml,250,20,1,21,940,18800,39179.72
14-Aug-23,Tista,Clean 100ml,250,60,5,65,940,56400,51194.21
30-Jul-23,Tista,Clean 100ml,250,21,1,22,940,19740,39179.72
17-Jul-23,Tista,Clean 100ml,250,5,0,5,940,4700,15288.78
5-Jul-23,Tista,Clean 100ml,250,20,1,21,940,18800,31282.74
20-Jun-23,Tista,Clean 100ml,250,20,1,21,940,18800,72218.95
10-Jun-23,Tista,Clean 100ml,250,20,1,21,940,18800,29123.65
6-Jun-23,Tista,Clean 100ml,250,3,0,3,940,2820,9452.39
20-May-23,Tista,Clean 100ml,250,15,0,15,940,14100,9452.39
20-May-23,Tista,Clean 100ml,250,5,1,6,940,4700,9452.39
15-May-23,Tista,Clean 100ml,250,20,1,21,940,18800,39179.72
9-May-23,Tista,Clean 100ml,250,6,0,6,940,5640,14263.68
7-May-23,Tista,Clean 100ml,250,3,0,3,940,2820,15288.78
3-May-23,Tista,Clean 100ml,250,60,5,65,940,56400,51194.21
6-Apr-23,Tista,Clean 100ml,250,20,1,21,940,18800,39179.72
1-Apr-23,Tista,Viusid Vet 500ml,1296,2,0,2,2260,4520,9452.39
28-Mar-23,Tista,Clean 100ml,250,5,0,5,940,4700,14263.68
28-Mar-23,Tista,Clean 100ml,250,5,0,5,940,4700,14263.68
27-Mar-23,Tista,Clean 100ml,250,20,1,21,940,18800,29123.65
5-Mar-23,Tista,Viusid Vet 500ml,1347,2,0,2,2260,4520,75035.99
5-Mar-23,Tista,Clean 100ml,250,60,5,65,940,56400,89936.3
23-Feb-23,Tista,Clean 100ml,250,20,1,21,940,18800,39179.72
20-Feb-23,Tista,Clean 100ml,250,150,18,168,940,141000,73816.29
29-Jan-23,Tista,Clean 100ml,250,20,1,21,940,18800,12264.21
25-Jan-23,Tista,Clean 100ml,250,20,1,21,940,18800,39179.72
24-Jan-23,Tista,Clean 100ml,250,5,0,5,940,4700,14263.68
18-Jan-23,Tista,Clean 100ml,250,5,0,5,940,4700,14263.68
17-Jan-23,Tista,Clean 100ml,250,100,11,111,940,94000,75035.99
16-Jan-23,Tista,Clean 100ml,250,25,1,26,940,23500,31710.1
7-Jan-23,Tista,Clean 100ml,250,4,0,4,940,3760,9452.39
7-Jan-23,Tista,Clean 100ml,250,20,1,21,940,18800,28887.81
3-Jan-23,Tista,Clean 100ml,250,20,1,21,940,18800,29123.65
29-Dec-22,Tista,Clean 100ml,250,40,3,43,940,37600,21946.46
27-Dec-22,Tista,Clean 100ml,250,60,5,65,940,56400,51194.21
21-Dec-22,Tista,Clean 100ml,250,100,11,111,940,94000,87161.63
8-Nov-22,Tista,Clean 100ml,250,20,1,21,940,18800,33998
13-Oct-22,Tista,Clean 100ml,250,20,1,21,940,18800,73816.29
11-Oct-22,Tista,Fresmin F 10kg,2178,1,0,1,4595,4595,53106.77
30-Sep-22,Tista,Clean 100ml,250,20,1,21,940,18800,72218.95
26-Sep-22,Tista,Clean 100ml,250,0,1,1,940,0,31710.1
10-Sep-22,Tista,Clean 100ml,250,20,1,21,940,18800,24413.58
4-Sep-22,Tista,Clean 100ml,250,20,1,21,940,18800,15288.78
25-Aug-22,Tista,Clean 100ml,250,20,1,21,940,18800,33998
24-Aug-22,Tista,Clean 100ml,250,100,12,112,940,94000,89936.3
21-Aug-22,Tista,Clean 100ml,250,5,0,5,940,4700,11361.43
14-Aug-22,Tista,Clean 100ml,250,20,1,21,940,18800,51194.21
14-Aug-22,Tista,Clean 100ml,250,20,1,21,940,18800,29123.65
8-Aug-22,Tista,Clean 100ml,250,50,4,54,940,47000,89936.3
2-Aug-22,Tista,Clean 100ml,250,50,4,54,940,47000,87161.63
31-Jul-22,Tista,Clean 100ml,250,5,0,5,940,4700,14263.68
28-Jul-22,Tista,Clean 100ml,250,20,1,21,940,18800,12169.88
28-Jul-22,Tista,Clean 100ml,250,5,0,5,940,4700,21946.46
24-Jul-22,Tista,Clean 100ml,250,100,11,111,940,94000,75035.99
12-May-22,Tista,Clean 100ml,1,20,1,21,940,18800,73816.29
11-May-22,Tista,Clean 100ml,1,20,1,21,940,18800,28887.81
24-Apr-22,Tista,Clean 100ml,1,40,3,43,940,37600,17329.63
24-Apr-22,Tista,Clean 100ml,1,20,1,21,940,18800,72218.95
24-Apr-22,Tista,Clean 100ml,1,5,0,5,940,4700,21946.46
24-Apr-22,Tista,Clean 100ml,1,5,0,5,940,4700,31282.74
24-Apr-22,Tista,Clean 100ml,1,20,1,21,940,18800,89936.3
22-Oct-23,Turag,Clean 100ml,250,100,8,108,940,94000,96198.85
4-Oct-23,Turag,Clean 100ml,250,45,3,48,940,42300,58121.87
3-Oct-23,Turag,Clean 100ml,250,200,24,224,940,188000,59353.19
1-Oct-23,Turag,Clean 100ml,250,41,2,43,940,38540,45183.82
20-Sep-23,Turag,Clean 100ml,250,45,3,48,940,42300,30232.75
11-Sep-23,Turag,Clean 100ml,250,45,0,45,940,42300,78352.4
11-Sep-23,Turag,Clean 100ml,250,7,2,9,940,6580,78352.4
27-Aug-23,Turag,Clean 100ml,250,10,0,10,940,9400,19464.3
19-Aug-23,Turag,Clean 100ml,250,38,2,40,940,35720,29156.63
6-Aug-23,Turag,Clean 100ml,250,10,0,10,940,9400,26040.99
23-Jul-23,Turag,Clean 100ml,250,33,3,36,940,31020,45183.82
23-Jul-23,Turag,Clean 100ml,250,10,0,10,940,9400,45183.82
19-Jul-23,Turag,Clean 100ml,250,23,1,24,940,21620,28202.44
16-Jul-23,Turag,Clean 100ml,250,32,1,33,940,30080,31111.74
10-Jul-23,Turag,Clean 100ml,250,23,1,24,940,21620,31111.74
26-Jun-23,Turag,Clean 100ml,250,12,0,12,940,11280,19017.96
26-Jun-23,Turag,Clean 100ml,250,5,0,5,940,4700,19017.96
25-Jun-23,Turag,Clean 100ml,250,28,0,28,940,26320,19017.96
22-Jun-23,Turag,Clean 100ml,250,6,0,6,940,5640,26040.99
4-Jun-23,Turag,Clean 100ml,250,100,0,100,940,94000,59353.19
4-Jun-23,Turag,Clean 100ml,250,0,10,10,940,0,59353.19
8-May-23,Turag,Clean 100ml,250,45,5,50,940,42300,58121.87
8-May-23,Turag,Clean 100ml,250,15,0,15,940,14100,58121.87
18-Apr-23,Turag,Clean 100ml,250,10,0,10,940,9400,28202.44
15-Apr-23,Turag,Clean 100ml,250,1,0,1,940,940,31111.74
10-Apr-23,Turag,Clean 100ml,250,3,0,3,940,2820,31111.74
10-Apr-23,Turag,Clean 100ml,250,23,0,23,940,21620,31111.74
6-Apr-23,Turag,Clean 100ml,250,100,8,108,940,94000,96198.85
28-Mar-23,Turag,Clean 100ml,250,5,0,5,940,4700,27763.55
13-Mar-23,Turag,Clean 100ml,250,65,4,69,940,61100,59353.19
7-Mar-23,Turag,Clean 100ml,250,100,9,109,940,94000,80391.06
7-Mar-23,Turag,Clean 100ml,250,6,0,6,940,5640,89994.84
7-Mar-23,Turag,Clean 100ml,250,10,0,10,940,9400,89994.84
7-Mar-23,Turag,Clean 100ml,250,47,0,47,940,44180,89994.84
7-Mar-23,Turag,Clean 100ml,250,37,0,37,940,34780,89994.84
6-Mar-23,Turag,Clean 100ml,250,50,3,53,940,47000,59353.19
27-Feb-23,Turag,Clean 100ml,250,150,0,150,940,141000,89994.84
23-Feb-23,Turag,Clean 100ml,250,78,6,84,940,73320,78352.4
23-Feb-23,Turag,Clean 100ml,250,43,2,45,940,40420,78352.4
23-Feb-23,Turag,Clean 100ml,250,11,0,11,940,10340,89994.84
7-Feb-23,Turag,Clean 100ml,250,65,5,70,940,61100,58121.87
5-Feb-23,Turag,Clean 100ml,250,2,0,2,940,1880,6675.05
5-Feb-23,Turag,Clean 100ml,250,59,0,59,940,55460,47965.05
5-Feb-23,Turag,Clean 100ml,250,1,3,4,940,940,47965.05
2-Feb-23,Turag,Clean 100ml,250,60,5,65,940,56400,30232.75
2-Feb-23,Turag,Clean 100ml,250,6,0,6,940,5640,26040.99
31-Jan-23,Turag,Clean 100ml,250,60,5,65,940,56400,96198.85
25-Jan-23,Turag,Clean 100ml,250,20,1,21,940,18800,16674.7
21-Jan-23,Turag,Clean 100ml,250,20,1,21,940,18800,28202.44
19-Jan-23,Turag,Clean 100ml,250,30,2,32,940,28200,30232.75
16-Jan-23,Turag,Clean 100ml,250,60,4,64,940,56400,59353.19
8-Jan-23,Turag,Clean 100ml,250,60,5,65,940,56400,96198.85
8-Jan-23,Turag,Clean 100ml,250,10,0,10,940,9400,28202.44
4-Jan-23,Turag,Clean 100ml,250,50,3,53,940,47000,47965.05
2-Jan-23,Turag,Clean 100ml,250,14,0,14,940,13160,11712.4
22-Dec-22,Turag,Clean 100ml,250,20,1,21,940,18800,30232.75
20-Dec-22,Turag,Clean 100ml,250,60,4,64,940,56400,80391.06
20-Dec-22,Turag,Clean 100ml,250,60,4,64,940,56400,62324.55
13-Dec-22,Turag,Clean 100ml,250,17,0,17,940,15980,24706.48
13-Dec-22,Turag,Clean 100ml,250,8,1,9,940,7520,24706.48
13-Dec-22,Turag,Clean 100ml,250,50,3,53,940,47000,58121.87
1-Oct-22,Turag,Clean 100ml,250,18,0,18,940,16920,31111.74
1-Oct-22,Turag,Clean 100ml,250,2,0,2,940,1880,31111.74
22-Sep-22,Turag,Clean 100ml,250,6,0,6,940,5640,4032.48
21-Sep-22,Turag,Clean 100ml,250,60,5,65,940,56400,80391.06
17-Sep-22,Turag,Clean 100ml,250,39,1,40,940,36660,23633.44
11-Sep-22,Turag,Clean 100ml,250,30,0,30,940,28200,31111.74
7-Sep-22,Turag,Clean 100ml,250,24,0,24,940,22560,18724.8
1-Sep-22,Turag,Clean 100ml,250,14,0,14,940,13160,16674.7
21-Aug-22,Turag,Clean 100ml,250,45,0,45,940,42300,80391.06
21-Aug-22,Turag,Clean 100ml,250,7,0,7,940,6580,80391.06
21-Aug-22,Turag,Clean 100ml,250,8,5,13,940,7520,80391.06
21-Aug-22,Turag,Clean 100ml,250,100,12,112,940,94000,62324.55
8-Aug-22,Turag,Clean 100ml,250,92,6,98,940,86480,93849.58
5-Aug-22,Turag,Clean 100ml,250,18,0,18,940,16920,23633.44
1-Aug-22,Turag,Clean 100ml,250,29,1,30,940,27260,23633.44
1-Aug-22,Turag,Clean 100ml,250,60,4,64,940,56400,23633.44
31-Jul-22,Turag,Clean 100ml,250,60,5,65,940,56400,80391.06
31-Jul-22,Turag,Clean 100ml,250,100,11,111,940,94000,62324.55
31-Jul-22,Turag,Clean 100ml,250,8,0,8,940,7520,41572.69
27-Jul-22,Turag,Clean 100ml,250,8,0,8,940,7520,24706.48
26-Jul-22,Turag,Clean 100ml,250,68,0,68,940,63920,89994.84
26-Jul-22,Turag,Clean 100ml,250,42,3,45,940,39480,22755.07
17-Jun-22,Turag,Clean 100ml,1,15,0,15,940,14100,23633.44
17-Jun-22,Turag,Clean 100ml,250,8,0,8,940,7520,23633.44
4-Jun-22,Turag,Clean 100ml,250,27,0,27,940,25380,78352.4
30-May-22,Turag,Clean 100ml,1,3,0,3,940,2820,4032.48
23-May-22,Turag,Clean 100ml,250,20,0,20,940,18800,28202.44
23-May-22,Turag,Clean 100ml,1,8,0,8,940,7520,16674.7
15-May-22,Turag,Clean 100ml,250,5,0,5,940,4700,26040.99
27-Apr-22,Turag,Clean 100ml,1,26,0,26,940,24440,89994.84
25-Apr-22,Turag,Clean 100ml,1,70,0,70,940,65800,89994.84
25-Apr-22,Turag,Clean 100ml,1,3,0,3,940,2820,4032.48
24-Nov-22,Turag,Clean 100ml,1,0,0,0,940,0,96198.85
23-Apr-22,Turag,Clean 100ml,250,60,5,65,940,56400,96198.85
24-Nov-22,Turag,Clean 100ml,1,0,0,0,940,0,28202.44
23-Apr-22,Turag,Clean 100ml,250,20,1,21,940,18800,28202.44
22-Apr-22,Turag,Clean 100ml,1,28,0,28,940,26320,78352.4
22-Apr-22,Turag,Clean 100ml,1,60,5,65,940,56400,80391.06
